Splice the 2rd letter of "born", the 3th letter of "Asian", and the 6th letter of "hardware" together.	oia
Splice the 2rd letter of "gown", the 2rd letter of "about", and the 5th letter of "tablet" together.	obe
Splice the 2rd letter of "joint", the 6th letter of "illegal", and the 3th letter of "hook" together.	oao
Splice the 6th letter of "violet", the 4th letter of "sugar", and the 3th letter of "acute" together.	tau
Splice the 1st letter of "entrance", the 5th letter of "possess", and the 3th letter of "official" together.	eef
Splice the 6th letter of "Communism", the 1st letter of "prior", and the 3th letter of "eighth" together.	npg
Splice the 3th letter of "tablet", the 1st letter of "plough", and the 6th letter of "Canada" together.	bpa
Splice the 5th letter of "grave", the 4th letter of "dispose", and the 2rd letter of "coin" together.	epo
Splice the 4th letter of "possess", the 6th letter of "college", and the 1st letter of "attitude" together.	sga
Splice the 3th letter of "possess", the 4th letter of "sometime", and the 5th letter of "butcher" together.	seh
Splice the 6th letter of "turnip", the 2rd letter of "tablet", and the 4th letter of "coin" together.	pan
Splice the 4th letter of "manual", the 3th letter of "represent", and the 4th letter of "official" together.	upi
Splice the 5th letter of "plough", the 3th letter of "rival", and the 1st letter of "gown" together.	gvg
Splice the 3th letter of "accident", the 7th letter of "president", and the 3th letter of "radiation" together.	ced
Splice the 5th letter of "recover", the 2rd letter of "center", and the 2rd letter of "reed" together.	vee
Splice the 3th letter of "coin", the 5th letter of "career", and the 4th letter of "around" together.	ieu
Splice the 6th letter of "laundry", the 5th letter of "supper", and the 3th letter of "lumber" together.	rem
Splice the 7th letter of "involve", the 3th letter of "about", and the 1st letter of "sleep" together.	eos
Splice the 2rd letter of "card", the 2rd letter of "story", and the 6th letter of "greeting" together.	ati
Splice the 7th letter of "visible", the 4th letter of "popular", and the 7th letter of "district" together.	euc
Splice the 1st letter of "coin", the 3th letter of "hope", and the 3th letter of "acute" together.	cpu
Splice the 5th letter of "sleep", the 2rd letter of "file", and the 1st letter of "contrast" together.	pic
Splice the 1st letter of "spur", the 5th letter of "acute", and the 3th letter of "mate" together.	set
Splice the 1st letter of "float", the 4th letter of "mouse", and the 3th letter of "broken" together.	fso
Splice the 5th letter of "sleep", the 2rd letter of "official", and the 5th letter of "neglect" together.	pfe
Splice the 7th letter of "neglect", the 6th letter of "tomato", and the 1st letter of "float" together.	tof
Splice the 1st letter of "rival", the 3th letter of "ought", and the 3th letter of "file" together.	rgl
Splice the 4th letter of "gymnasium", the 4th letter of "insect", and the 1st letter of "mosquito" together.	nem
Splice the 1st letter of "attitude", the 4th letter of "supper", and the 2rd letter of "navy" together.	apa
Splice the 3th letter of "popular", the 7th letter of "entrance", and the 5th letter of "possess" together.	pce
Splice the 6th letter of "supper", the 6th letter of "insect", and the 7th letter of "represent" together.	rte
Splice the 2rd letter of "center", the 4th letter of "float", and the 2rd letter of "phase" together.	eah
Splice the 6th letter of "explosion", the 8th letter of "president", and the 3th letter of "neglect" together.	sng
Splice the 3th letter of "visible", the 4th letter of "contrast", and the 6th letter of "shriek" together.	stk
Splice the 2rd letter of "familiar", the 2rd letter of "neglect", and the 6th letter of "college" together.	aeg
Splice the 5th letter of "sleep", the 4th letter of "possess", and the 4th letter of "story" together.	psr
Splice the 6th letter of "lumber", the 2rd letter of "entrance", and the 7th letter of "involve" together.	rne
Splice the 6th letter of "mosquito", the 3th letter of "plough", and the 5th letter of "write" together.	ioe
Splice the 4th letter of "matter", the 2rd letter of "radiation", and the 8th letter of "mosquito" together.	tao
Splice the 2rd letter of "anger", the 5th letter of "turnip", and the 4th letter of "supper" together.	nip
Splice the 2rd letter of "lean", the 6th letter of "eighth", and the 9th letter of "statement" together.	eht
Splice the 6th letter of "sometime", the 1st letter of "accident", and the 3th letter of "India" together.	iad
Splice the 4th letter of "shady", the 4th letter of "college", and the 3th letter of "represent" together.	dlp
Splice the 4th letter of "gown", the 3th letter of "joint", and the 1st letter of "hear" together.	nih
Splice the 4th letter of "Asian", the 2rd letter of "India", and the 3th letter of "prior" together.	ani
Splice the 1st letter of "joint", the 8th letter of "velocity", and the 2rd letter of "official" together.	jyf
Splice the 1st letter of "district", the 6th letter of "neighbour", and the 2rd letter of "about" together.	dbb
Splice the 2rd letter of "tomato", the 4th letter of "grave", and the 3th letter of "sleep" together.	ove
Splice the 1st letter of "evil", the 1st letter of "whoever", and the 4th letter of "rabbit" together.	ewb
Splice the 1st letter of "hook", the 4th letter of "sometime", and the 2rd letter of "joint" together.	heo
Splice the 1st letter of "ought", the 1st letter of "rival", and the 5th letter of "lumber" together.	ore
Splice the 7th letter of "mosquito", the 2rd letter of "soap", and the 9th letter of "Communism" together.	tom
Splice the 6th letter of "visible", the 1st letter of "familiar", and the 3th letter of "explore" together.	lfp
Splice the 3th letter of "accident", the 1st letter of "sleep", and the 1st letter of "grave" together.	csg
Splice the 4th letter of "gown", the 2rd letter of "tablet", and the 2rd letter of "sleep" together.	nal
Splice the 3th letter of "possess", the 5th letter of "class", and the 3th letter of "reed" together.	sse
Splice the 4th letter of "whoever", the 5th letter of "president", and the 5th letter of "class" together.	eis
Splice the 7th letter of "security", the 4th letter of "ought", and the 3th letter of "tablet" together.	thb
Splice the 2rd letter of "around", the 4th letter of "plough", and the 3th letter of "hear" together.	rua
Splice the 7th letter of "confirm", the 3th letter of "career", and the 4th letter of "card" together.	mrd
Splice the 1st letter of "Asian", the 6th letter of "accident", and the 5th letter of "president" together.	Aei
Splice the 6th letter of "around", the 2rd letter of "rival", and the 1st letter of "district" together.	did
Splice the 5th letter of "recover", the 1st letter of "prior", and the 4th letter of "shriek" together.	vpi
Splice the 5th letter of "career", the 7th letter of "gymnasium", and the 6th letter of "turbulent" together.	eil
Splice the 5th letter of "hardware", the 2rd letter of "phase", and the 3th letter of "file" together.	whl
Splice the 2rd letter of "retain", the 1st letter of "rival", and the 4th letter of "popular" together.	eru
Splice the 8th letter of "turbulent", the 5th letter of "insect", and the 1st letter of "each" together.	nce
Splice the 3th letter of "card", the 4th letter of "broken", and the 1st letter of "hear" together.	rkh
Splice the 1st letter of "navy", the 6th letter of "illegal", and the 6th letter of "college" together.	nag
Splice the 4th letter of "sleep", the 2rd letter of "explore", and the 3th letter of "illegal" together.	exl
Splice the 3th letter of "write", the 1st letter of "write", and the 2rd letter of "rabbit" together.	iwa
Splice the 4th letter of "tomato", the 1st letter of "rabbit", and the 8th letter of "greeting" together.	arg
Splice the 6th letter of "greeting", the 6th letter of "president", and the 6th letter of "broken" together.	idn
Splice the 3th letter of "around", the 1st letter of "whoever", and the 1st letter of "hear" together.	owh
Splice the 2rd letter of "lean", the 2rd letter of "file", and the 1st letter of "lean" together.	eil
Splice the 1st letter of "pull", the 2rd letter of "float", and the 2rd letter of "gown" together.	plo
Splice the 7th letter of "confirm", the 3th letter of "eighth", and the 2rd letter of "around" together.	mgr
Splice the 6th letter of "mosquito", the 3th letter of "neglect", and the 6th letter of "eighth" together.	igh
Splice the 5th letter of "attitude", the 3th letter of "popular", and the 3th letter of "college" together.	tpl
Splice the 7th letter of "sometime", the 7th letter of "contrast", and the 3th letter of "retain" together.	mst
Splice the 4th letter of "center", the 5th letter of "story", and the 2rd letter of "retain" together.	tye
Splice the 6th letter of "insect", the 3th letter of "Communism", and the 1st letter of "broken" together.	tmb
Splice the 5th letter of "college", the 6th letter of "laundry", and the 4th letter of "turbulent" together.	erb
Splice the 6th letter of "statement", the 7th letter of "popular", and the 3th letter of "plough" together.	mro
Splice the 4th letter of "soap", the 3th letter of "sugar", and the 5th letter of "neglect" together.	pge
Splice the 2rd letter of "retain", the 4th letter of "plough", and the 3th letter of "career" together.	eur
Splice the 1st letter of "float", the 6th letter of "attitude", and the 2rd letter of "mouse" together.	fuo
Splice the 4th letter of "hear", the 8th letter of "elevator", and the 3th letter of "hardly" together.	rrr
Splice the 4th letter of "sometime", the 3th letter of "gown", and the 4th letter of "popular" together.	ewu
Splice the 4th letter of "evil", the 2rd letter of "float", and the 2rd letter of "each" together.	lla
Splice the 4th letter of "eighth", the 2rd letter of "hardly", and the 7th letter of "illegal" together.	hal
Splice the 7th letter of "mosquito", the 3th letter of "turbulent", and the 2rd letter of "qualify" together.	tru
Splice the 5th letter of "butcher", the 2rd letter of "insect", and the 1st letter of "pull" together.	hnp
Splice the 2rd letter of "popular", the 6th letter of "recover", and the 2rd letter of "write" together.	oer
Splice the 5th letter of "story", the 4th letter of "write", and the 4th letter of "rival" together.	yta
Splice the 1st letter of "float", the 5th letter of "tablet", and the 1st letter of "turnip" together.	fet
Splice the 8th letter of "attitude", the 1st letter of "plough", and the 7th letter of "velocity" together.	ept
Splice the 1st letter of "each", the 1st letter of "hardly", and the 1st letter of "manual" together.	ehm
Splice the 1st letter of "write", the 3th letter of "prior", and the 7th letter of "college" together.	wie
Splice the 9th letter of "neighbour", the 3th letter of "manual", and the 6th letter of "ladder" together.	rnr
Splice the 4th letter of "president", the 4th letter of "class", and the 3th letter of "shriek" together.	ssr
Splice the 1st letter of "born", the 3th letter of "hope", and the 2rd letter of "about" together.	bpb
Splice the 2rd letter of "dispose", the 5th letter of "turbulent", and the 7th letter of "elevator" together.	iuo
Splice the 3th letter of "eighth", the 3th letter of "rabbit", and the 9th letter of "radiation" together.	gbn
Splice the 3th letter of "mate", the 7th letter of "explore", and the 8th letter of "Communism" together.	tes
Splice the 5th letter of "tablet", the 3th letter of "anger", and the 3th letter of "hook" together.	ego
Splice the 4th letter of "follow", the 1st letter of "sugar", and the 3th letter of "illegal" together.	lsl
Splice the 4th letter of "mosquito", the 5th letter of "tablet", and the 3th letter of "turbulent" together.	qer
Splice the 7th letter of "popular", the 6th letter of "manual", and the 4th letter of "rabbit" together.	rlb
Splice the 4th letter of "spur", the 5th letter of "class", and the 1st letter of "sometime" together.	rss
Splice the 2rd letter of "navy", the 4th letter of "ever", and the 2rd letter of "evil" together.	arv
Splice the 2rd letter of "matter", the 5th letter of "mouse", and the 5th letter of "explosion" together.	aeo
Splice the 7th letter of "radiation", the 3th letter of "recover", and the 5th letter of "elevator" together.	ica
Splice the 5th letter of "grave", the 2rd letter of "butcher", and the 3th letter of "hope" together.	eup
Splice the 3th letter of "shade", the 3th letter of "elevator", and the 1st letter of "prior" together.	aep
Splice the 6th letter of "rabbit", the 5th letter of "turnip", and the 3th letter of "lean" together.	tia
Splice the 3th letter of "retain", the 8th letter of "elevator", and the 3th letter of "Canada" together.	trn
Splice the 4th letter of "file", the 7th letter of "hardware", and the 1st letter of "mosquito" together.	erm
Splice the 9th letter of "turbulent", the 2rd letter of "tomato", and the 3th letter of "manual" together.	ton
Splice the 4th letter of "sleep", the 5th letter of "rabbit", and the 3th letter of "evil" together.	eii
Splice the 6th letter of "hardly", the 5th letter of "ladder", and the 1st letter of "shady" together.	yes
Splice the 4th letter of "outlet", the 6th letter of "retain", and the 1st letter of "grave" together.	lng
Splice the 3th letter of "neglect", the 5th letter of "broken", and the 4th letter of "hook" together.	gek
Splice the 7th letter of "familiar", the 3th letter of "Asian", and the 5th letter of "story" together.	aiy
Splice the 2rd letter of "shady", the 5th letter of "shriek", and the 4th letter of "sugar" together.	hea
Splice the 4th letter of "involve", the 4th letter of "violet", and the 2rd letter of "shriek" together.	olh
Splice the 1st letter of "recover", the 5th letter of "popular", and the 1st letter of "accident" together.	rla
Splice the 7th letter of "official", the 4th letter of "class", and the 3th letter of "evil" together.	asi
Splice the 8th letter of "sometime", the 2rd letter of "card", and the 5th letter of "neighbour" together.	eah
Splice the 1st letter of "write", the 5th letter of "whoever", and the 7th letter of "sometime" together.	wvm
Splice the 3th letter of "butcher", the 2rd letter of "anger", and the 5th letter of "broken" together.	tne
Splice the 5th letter of "prior", the 2rd letter of "career", and the 1st letter of "rival" together.	rar
Splice the 5th letter of "confirm", the 4th letter of "about", and the 5th letter of "joint" together.	iut
Splice the 4th letter of "mate", the 1st letter of "ever", and the 4th letter of "lean" together.	een
Splice the 3th letter of "velocity", the 2rd letter of "sugar", and the 3th letter of "gymnasium" together.	lum
Splice the 3th letter of "familiar", the 3th letter of "story", and the 3th letter of "neighbour" together.	moi
Splice the 3th letter of "spur", the 1st letter of "hardly", and the 4th letter of "hear" together.	uhr
Splice the 7th letter of "popular", the 5th letter of "joint", and the 2rd letter of "acute" together.	rtc
Splice the 2rd letter of "matter", the 7th letter of "confirm", and the 1st letter of "radiation" together.	amr
Splice the 2rd letter of "district", the 5th letter of "phase", and the 3th letter of "born" together.	ier
Splice the 2rd letter of "rival", the 3th letter of "mouse", and the 5th letter of "plough" together.	iug
Splice the 6th letter of "attitude", the 5th letter of "explosion", and the 4th letter of "navy" together.	uoy
Splice the 2rd letter of "hope", the 5th letter of "attitude", and the 8th letter of "explosion" together.	oto
Splice the 6th letter of "gymnasium", the 5th letter of "supper", and the 1st letter of "each" together.	see
Splice the 1st letter of "soap", the 1st letter of "Canada", and the 8th letter of "security" together.	sCy
Splice the 8th letter of "velocity", the 9th letter of "neighbour", and the 3th letter of "anger" together.	yrg
Splice the 4th letter of "joint", the 4th letter of "dispose", and the 5th letter of "float" together.	npt
Splice the 9th letter of "represent", the 4th letter of "supper", and the 6th letter of "violet" together.	tpt
Splice the 2rd letter of "reed", the 6th letter of "elevator", and the 5th letter of "matter" together.	ete
Splice the 3th letter of "eighth", the 2rd letter of "visible", and the 4th letter of "supper" together.	gip
Splice the 2rd letter of "accident", the 2rd letter of "popular", and the 3th letter of "explore" together.	cop
Splice the 1st letter of "neighbour", the 4th letter of "popular", and the 2rd letter of "neglect" together.	nue
Splice the 2rd letter of "sugar", the 4th letter of "outlet", and the 4th letter of "plough" together.	ulu
Splice the 4th letter of "story", the 2rd letter of "reed", and the 1st letter of "violet" together.	rev
Splice the 4th letter of "pull", the 1st letter of "ought", and the 3th letter of "shade" together.	loa
Splice the 4th letter of "involve", the 5th letter of "lumber", and the 2rd letter of "insect" together.	oen
Splice the 3th letter of "center", the 3th letter of "tablet", and the 1st letter of "sometime" together.	nbs
Splice the 2rd letter of "gown", the 3th letter of "hook", and the 4th letter of "illegal" together.	ooe
Splice the 3th letter of "each", the 5th letter of "president", and the 3th letter of "outlet" together.	cit
Splice the 5th letter of "entrance", the 2rd letter of "velocity", and the 3th letter of "phase" together.	aea
Splice the 1st letter of "ladder", the 1st letter of "hook", and the 4th letter of "eighth" together.	lhh
Splice the 4th letter of "qualify", the 3th letter of "phase", and the 2rd letter of "familiar" together.	laa
Splice the 3th letter of "prior", the 3th letter of "spur", and the 2rd letter of "ought" together.	iuu
Splice the 6th letter of "tomato", the 1st letter of "pull", and the 3th letter of "shady" together.	opa
Splice the 4th letter of "lean", the 7th letter of "district", and the 7th letter of "dispose" together.	nce
Splice the 1st letter of "involve", the 6th letter of "manual", and the 2rd letter of "matter" together.	ila
Splice the 3th letter of "mouse", the 2rd letter of "hardware", and the 5th letter of "center" together.	uae
Splice the 7th letter of "mosquito", the 2rd letter of "radiation", and the 2rd letter of "pull" together.	tau
Splice the 9th letter of "statement", the 3th letter of "outlet", and the 1st letter of "hardly" together.	tth
Splice the 5th letter of "Communism", the 2rd letter of "shade", and the 1st letter of "prior" together.	uhp
Splice the 3th letter of "security", the 5th letter of "explore", and the 6th letter of "contrast" together.	coa
Splice the 1st letter of "eighth", the 3th letter of "soap", and the 2rd letter of "Asian" together.	eas
Splice the 6th letter of "hardly", the 6th letter of "insect", and the 5th letter of "plough" together.	ytg
Splice the 1st letter of "involve", the 1st letter of "navy", and the 1st letter of "confirm" together.	inc
Splice the 6th letter of "greeting", the 7th letter of "radiation", and the 5th letter of "phase" together.	iie
Splice the 2rd letter of "Asian", the 3th letter of "write", and the 4th letter of "security" together.	siu
Splice the 7th letter of "attitude", the 3th letter of "familiar", and the 4th letter of "whoever" together.	dme
Splice the 6th letter of "lumber", the 4th letter of "explore", and the 6th letter of "supper" together.	rlr
Splice the 2rd letter of "sleep", the 2rd letter of "contrast", and the 6th letter of "broken" together.	lon
Splice the 1st letter of "entrance", the 2rd letter of "navy", and the 4th letter of "ever" together.	ear
Splice the 4th letter of "dispose", the 8th letter of "velocity", and the 4th letter of "hardware" together.	pyd
Splice the 3th letter of "confirm", the 2rd letter of "illegal", and the 9th letter of "turbulent" together.	nlt
Splice the 1st letter of "statement", the 1st letter of "turbulent", and the 3th letter of "whoever" together.	sto
Splice the 1st letter of "radiation", the 3th letter of "hear", and the 6th letter of "ladder" together.	rar
Splice the 2rd letter of "shriek", the 5th letter of "mouse", and the 3th letter of "prior" together.	hei
Splice the 3th letter of "evil", the 4th letter of "mosquito", and the 1st letter of "around" together.	iqa
Splice the 2rd letter of "butcher", the 6th letter of "neighbour", and the 3th letter of "violet" together.	ubo
Splice the 1st letter of "gymnasium", the 4th letter of "eighth", and the 4th letter of "attitude" together.	ghi
Splice the 4th letter of "each", the 4th letter of "sleep", and the 6th letter of "outlet" together.	het
Splice the 2rd letter of "mosquito", the 1st letter of "sleep", and the 3th letter of "hardware" together.	osr
Splice the 5th letter of "sleep", the 3th letter of "velocity", and the 3th letter of "navy" together.	plv
Splice the 4th letter of "involve", the 3th letter of "India", and the 8th letter of "official" together.	odl
Splice the 1st letter of "card", the 2rd letter of "velocity", and the 2rd letter of "gown" together.	ceo
Splice the 5th letter of "laundry", the 5th letter of "neglect", and the 4th letter of "hook" together.	dek
Splice the 6th letter of "velocity", the 3th letter of "sugar", and the 3th letter of "lean" together.	iga
Splice the 5th letter of "story", the 5th letter of "popular", and the 5th letter of "rival" together.	yll
Splice the 4th letter of "butcher", the 4th letter of "dispose", and the 1st letter of "hear" together.	cph
Splice the 6th letter of "neglect", the 3th letter of "hear", and the 1st letter of "lean" together.	cal
Splice the 6th letter of "follow", the 2rd letter of "gown", and the 1st letter of "lean" together.	wol
Splice the 2rd letter of "retain", the 1st letter of "card", and the 6th letter of "plough" together.	ech
Splice the 8th letter of "president", the 2rd letter of "radiation", and the 1st letter of "popular" together.	nap
Splice the 3th letter of "spur", the 5th letter of "acute", and the 6th letter of "turnip" together.	uep
Splice the 7th letter of "contrast", the 6th letter of "retain", and the 6th letter of "radiation" together.	snt
Splice the 3th letter of "Asian", the 5th letter of "accident", and the 4th letter of "navy" together.	idy
Splice the 4th letter of "violet", the 1st letter of "spur", and the 1st letter of "plough" together.	lsp
Splice the 9th letter of "statement", the 4th letter of "spur", and the 4th letter of "born" together.	trn
Splice the 4th letter of "gymnasium", the 6th letter of "neglect", and the 2rd letter of "illegal" together.	ncl
Splice the 5th letter of "India", the 5th letter of "atomic", and the 1st letter of "navy" together.	ain
Splice the 4th letter of "each", the 5th letter of "atomic", and the 6th letter of "broken" together.	hin
Splice the 4th letter of "card", the 1st letter of "Canada", and the 4th letter of "mouse" together.	dCs
Splice the 1st letter of "Canada", the 3th letter of "mate", and the 3th letter of "follow" together.	Ctl
Splice the 3th letter of "hook", the 4th letter of "security", and the 4th letter of "popular" together.	ouu
Splice the 3th letter of "explore", the 4th letter of "college", and the 2rd letter of "ever" together.	plv
Splice the 4th letter of "ladder", the 1st letter of "evil", and the 4th letter of "navy" together.	dey
Splice the 3th letter of "broken", the 1st letter of "around", and the 4th letter of "gown" together.	oan
Splice the 3th letter of "India", the 3th letter of "president", and the 3th letter of "each" together.	dec
Splice the 3th letter of "atomic", the 5th letter of "retain", and the 2rd letter of "tablet" together.	oia
Splice the 2rd letter of "file", the 7th letter of "familiar", and the 5th letter of "joint" together.	iat
Splice the 2rd letter of "shade", the 7th letter of "involve", and the 6th letter of "lumber" together.	her
Splice the 8th letter of "gymnasium", the 1st letter of "confirm", and the 1st letter of "shade" together.	ucs
Splice the 2rd letter of "security", the 6th letter of "greeting", and the 5th letter of "turbulent" together.	eiu
Splice the 1st letter of "shade", the 3th letter of "involve", and the 5th letter of "grave" together.	sve
Splice the 1st letter of "supper", the 7th letter of "accident", and the 1st letter of "attitude" together.	sna
Splice the 5th letter of "sometime", the 4th letter of "Asian", and the 5th letter of "about" together.	tat
Splice the 1st letter of "around", the 8th letter of "official", and the 8th letter of "accident" together.	alt
Splice the 6th letter of "Communism", the 1st letter of "each", and the 5th letter of "tablet" together.	nee
Splice the 3th letter of "accident", the 4th letter of "ever", and the 3th letter of "outlet" together.	crt
Splice the 4th letter of "supper", the 5th letter of "Asian", and the 4th letter of "broken" together.	pnk
Splice the 1st letter of "familiar", the 7th letter of "whoever", and the 2rd letter of "hear" together.	fre
Splice the 9th letter of "turbulent", the 6th letter of "possess", and the 6th letter of "violet" together.	tst
Splice the 3th letter of "turnip", the 4th letter of "each", and the 4th letter of "prior" together.	rho
Splice the 1st letter of "tablet", the 5th letter of "rabbit", and the 2rd letter of "born" together.	tio
Splice the 1st letter of "joint", the 3th letter of "story", and the 6th letter of "sometime" together.	joi
Splice the 8th letter of "attitude", the 4th letter of "hope", and the 4th letter of "radiation" together.	eei
Splice the 3th letter of "grave", the 4th letter of "pull", and the 3th letter of "plough" together.	alo
Splice the 3th letter of "president", the 9th letter of "represent", and the 5th letter of "class" together.	ets
Splice the 7th letter of "district", the 8th letter of "sometime", and the 5th letter of "involve" together.	cel
Splice the 2rd letter of "born", the 4th letter of "contrast", and the 9th letter of "statement" together.	ott
Splice the 3th letter of "prior", the 7th letter of "whoever", and the 3th letter of "matter" together.	irt
Splice the 8th letter of "mosquito", the 8th letter of "attitude", and the 2rd letter of "ladder" together.	oea
Splice the 2rd letter of "write", the 4th letter of "supper", and the 2rd letter of "float" together.	rpl
Splice the 7th letter of "accident", the 2rd letter of "center", and the 2rd letter of "mosquito" together.	neo
Splice the 7th letter of "illegal", the 6th letter of "neighbour", and the 4th letter of "butcher" together.	lbc
Splice the 7th letter of "neglect", the 3th letter of "center", and the 1st letter of "gown" together.	tng
Splice the 7th letter of "gymnasium", the 3th letter of "hardly", and the 1st letter of "shade" together.	irs
Splice the 4th letter of "spur", the 8th letter of "attitude", and the 7th letter of "sometime" together.	rem
Splice the 4th letter of "involve", the 4th letter of "turbulent", and the 4th letter of "popular" together.	obu
Splice the 4th letter of "security", the 2rd letter of "card", and the 8th letter of "district" together.	uat
Splice the 4th letter of "turbulent", the 3th letter of "recover", and the 6th letter of "explosion" together.	bcs
Splice the 2rd letter of "Communism", the 1st letter of "grave", and the 3th letter of "shady" together.	oga
Splice the 6th letter of "matter", the 5th letter of "manual", and the 2rd letter of "each" together.	raa
Splice the 4th letter of "official", the 7th letter of "accident", and the 5th letter of "class" together.	ins
Splice the 5th letter of "grave", the 6th letter of "official", and the 2rd letter of "atomic" together.	eit
Splice the 6th letter of "involve", the 2rd letter of "official", and the 5th letter of "about" together.	vft
Splice the 5th letter of "lumber", the 3th letter of "matter", and the 1st letter of "lean" together.	etl
Splice the 9th letter of "represent", the 6th letter of "eighth", and the 8th letter of "elevator" together.	thr
Splice the 4th letter of "each", the 6th letter of "whoever", and the 1st letter of "eighth" together.	hee
Splice the 4th letter of "shade", the 2rd letter of "Canada", and the 4th letter of "mosquito" together.	daq
Splice the 1st letter of "ever", the 4th letter of "sleep", and the 5th letter of "insect" together.	eec
Splice the 4th letter of "velocity", the 7th letter of "official", and the 4th letter of "sleep" together.	oae
Splice the 2rd letter of "pull", the 3th letter of "prior", and the 2rd letter of "plough" together.	uil
Splice the 2rd letter of "joint", the 8th letter of "turbulent", and the 4th letter of "turnip" together.	onn
Splice the 7th letter of "official", the 1st letter of "born", and the 7th letter of "dispose" together.	abe
Splice the 1st letter of "float", the 4th letter of "born", and the 7th letter of "popular" together.	fnr
Splice the 9th letter of "gymnasium", the 8th letter of "represent", and the 2rd letter of "broken" together.	mnr
Splice the 3th letter of "turnip", the 1st letter of "violet", and the 3th letter of "each" together.	rvc
Splice the 5th letter of "security", the 5th letter of "college", and the 3th letter of "retain" together.	ret
Splice the 5th letter of "hardly", the 2rd letter of "ought", and the 4th letter of "confirm" together.	luf
Splice the 8th letter of "hardware", the 6th letter of "atomic", and the 2rd letter of "statement" together.	ect
Splice the 1st letter of "district", the 7th letter of "whoever", and the 3th letter of "official" together.	drf
Splice the 2rd letter of "qualify", the 2rd letter of "shady", and the 4th letter of "explore" together.	uhl
Splice the 1st letter of "gymnasium", the 6th letter of "hardware", and the 2rd letter of "acute" together.	gac
Splice the 1st letter of "gown", the 1st letter of "file", and the 2rd letter of "accident" together.	gfc
Splice the 6th letter of "dispose", the 1st letter of "matter", and the 3th letter of "rival" together.	smv
Splice the 1st letter of "each", the 3th letter of "coin", and the 3th letter of "pull" together.	eil
Splice the 2rd letter of "anger", the 7th letter of "greeting", and the 4th letter of "born" together.	nnn
Splice the 4th letter of "broken", the 5th letter of "story", and the 4th letter of "plough" together.	kyu
Splice the 2rd letter of "follow", the 4th letter of "college", and the 6th letter of "neglect" together.	olc
Splice the 1st letter of "broken", the 1st letter of "whoever", and the 3th letter of "ought" together.	bwg
Splice the 3th letter of "velocity", the 2rd letter of "attitude", and the 5th letter of "greeting" together.	ltt
Splice the 4th letter of "sleep", the 2rd letter of "qualify", and the 1st letter of "hardly" together.	euh
Splice the 1st letter of "gymnasium", the 2rd letter of "hardly", and the 1st letter of "card" together.	gac
Splice the 3th letter of "gown", the 8th letter of "Communism", and the 2rd letter of "around" together.	wsr
Splice the 3th letter of "phase", the 5th letter of "butcher", and the 3th letter of "supper" together.	ahp
Splice the 1st letter of "float", the 1st letter of "soap", and the 1st letter of "born" together.	fsb
Splice the 1st letter of "reed", the 6th letter of "plough", and the 1st letter of "lumber" together.	rhl
Splice the 2rd letter of "sugar", the 4th letter of "broken", and the 1st letter of "ever" together.	uke
Splice the 3th letter of "gown", the 4th letter of "acute", and the 5th letter of "visible" together.	wtb
Splice the 1st letter of "dispose", the 3th letter of "recover", and the 3th letter of "each" together.	dcc
Splice the 2rd letter of "velocity", the 4th letter of "Asian", and the 5th letter of "shade" together.	eae
Splice the 2rd letter of "acute", the 2rd letter of "prior", and the 3th letter of "hope" together.	crp
Splice the 2rd letter of "acute", the 2rd letter of "atomic", and the 6th letter of "gymnasium" together.	cts
Splice the 5th letter of "sleep", the 2rd letter of "tablet", and the 1st letter of "reed" together.	par
Splice the 4th letter of "born", the 3th letter of "phase", and the 3th letter of "recover" together.	nac
Splice the 1st letter of "prior", the 7th letter of "recover", and the 1st letter of "ought" together.	pro
Splice the 3th letter of "qualify", the 4th letter of "shade", and the 3th letter of "tomato" together.	adm
Splice the 6th letter of "confirm", the 5th letter of "sometime", and the 7th letter of "familiar" together.	rta
Splice the 5th letter of "eighth", the 2rd letter of "qualify", and the 6th letter of "recover" together.	tue
Splice the 2rd letter of "college", the 3th letter of "prior", and the 6th letter of "retain" together.	oin
Splice the 4th letter of "neglect", the 1st letter of "navy", and the 4th letter of "career" together.	lne
Splice the 3th letter of "grave", the 4th letter of "ought", and the 6th letter of "lumber" together.	ahr
Splice the 8th letter of "official", the 6th letter of "whoever", and the 4th letter of "grave" together.	lev
Splice the 5th letter of "gymnasium", the 1st letter of "around", and the 3th letter of "Canada" together.	aan
Splice the 5th letter of "India", the 5th letter of "sugar", and the 4th letter of "shady" together.	ard
Splice the 6th letter of "insect", the 5th letter of "represent", and the 3th letter of "rival" together.	tev
Splice the 4th letter of "hardware", the 3th letter of "write", and the 2rd letter of "tomato" together.	dio
Splice the 4th letter of "tomato", the 5th letter of "whoever", and the 8th letter of "contrast" together.	avt
Splice the 3th letter of "butcher", the 3th letter of "mouse", and the 3th letter of "rival" together.	tuv
Splice the 1st letter of "broken", the 8th letter of "elevator", and the 1st letter of "eighth" together.	bre
Splice the 3th letter of "accident", the 6th letter of "matter", and the 4th letter of "Asian" together.	cra
Splice the 5th letter of "explore", the 6th letter of "hardware", and the 3th letter of "hope" together.	oap
Splice the 3th letter of "around", the 2rd letter of "anger", and the 1st letter of "qualify" together.	onq
Splice the 4th letter of "shady", the 1st letter of "joint", and the 1st letter of "explore" together.	dje
Splice the 1st letter of "violet", the 3th letter of "hear", and the 1st letter of "represent" together.	var
Splice the 3th letter of "eighth", the 4th letter of "mosquito", and the 3th letter of "hook" together.	gqo
Splice the 1st letter of "tablet", the 4th letter of "pull", and the 3th letter of "soap" together.	tla
Splice the 7th letter of "official", the 3th letter of "grave", and the 4th letter of "India" together.	aai
Splice the 3th letter of "file", the 2rd letter of "hook", and the 7th letter of "laundry" together.	loy
Splice the 8th letter of "gymnasium", the 5th letter of "matter", and the 4th letter of "mouse" together.	ues
Splice the 2rd letter of "Asian", the 2rd letter of "neighbour", and the 6th letter of "velocity" together.	sei
Splice the 6th letter of "illegal", the 1st letter of "story", and the 6th letter of "Communism" together.	asn
Splice the 3th letter of "ever", the 4th letter of "Communism", and the 4th letter of "center" together.	emt
Splice the 4th letter of "explosion", the 4th letter of "India", and the 1st letter of "outlet" together.	lio
Splice the 4th letter of "ladder", the 3th letter of "explore", and the 1st letter of "center" together.	dpc
Splice the 3th letter of "college", the 4th letter of "Canada", and the 3th letter of "neighbour" together.	lai
Splice the 3th letter of "each", the 6th letter of "manual", and the 4th letter of "sleep" together.	cle
Splice the 5th letter of "hardly", the 3th letter of "spur", and the 6th letter of "broken" together.	lun
Splice the 4th letter of "rabbit", the 2rd letter of "coin", and the 4th letter of "file" together.	boe
Splice the 2rd letter of "dispose", the 7th letter of "possess", and the 2rd letter of "rabbit" together.	isa
Splice the 8th letter of "district", the 5th letter of "manual", and the 8th letter of "entrance" together.	tae
Splice the 2rd letter of "recover", the 6th letter of "atomic", and the 1st letter of "hope" together.	ech
Splice the 3th letter of "president", the 7th letter of "district", and the 2rd letter of "center" together.	ece
Splice the 4th letter of "acute", the 3th letter of "card", and the 5th letter of "Canada" together.	trd
Splice the 4th letter of "gown", the 4th letter of "navy", and the 1st letter of "greeting" together.	nyg
Splice the 7th letter of "laundry", the 7th letter of "dispose", and the 6th letter of "represent" together.	yes
Splice the 2rd letter of "class", the 2rd letter of "tablet", and the 3th letter of "ought" together.	lag
Splice the 1st letter of "accident", the 4th letter of "write", and the 2rd letter of "born" together.	ato
Splice the 4th letter of "born", the 4th letter of "whoever", and the 5th letter of "illegal" together.	neg
Splice the 1st letter of "float", the 5th letter of "confirm", and the 4th letter of "acute" together.	fit
Splice the 7th letter of "radiation", the 3th letter of "hook", and the 2rd letter of "familiar" together.	ioa
Splice the 3th letter of "matter", the 4th letter of "reed", and the 5th letter of "phase" together.	tde
Splice the 5th letter of "security", the 4th letter of "rabbit", and the 3th letter of "matter" together.	rbt
Splice the 8th letter of "sometime", the 1st letter of "spur", and the 1st letter of "recover" together.	esr
Splice the 2rd letter of "evil", the 3th letter of "India", and the 6th letter of "visible" together.	vdl
Splice the 5th letter of "whoever", the 3th letter of "center", and the 4th letter of "district" together.	vnt
Splice the 1st letter of "qualify", the 5th letter of "butcher", and the 4th letter of "prior" together.	qho
Splice the 5th letter of "insect", the 4th letter of "spur", and the 1st letter of "atomic" together.	cra
Splice the 2rd letter of "sometime", the 2rd letter of "butcher", and the 2rd letter of "rabbit" together.	oua
Splice the 2rd letter of "possess", the 7th letter of "illegal", and the 3th letter of "involve" together.	olv
Splice the 2rd letter of "story", the 5th letter of "atomic", and the 1st letter of "hardly" together.	tih
Splice the 3th letter of "file", the 6th letter of "violet", and the 3th letter of "radiation" together.	ltd
Splice the 3th letter of "shady", the 1st letter of "broken", and the 9th letter of "explosion" together.	abn
Splice the 3th letter of "pull", the 3th letter of "sugar", and the 7th letter of "entrance" together.	lgc
Splice the 6th letter of "laundry", the 5th letter of "confirm", and the 1st letter of "sometime" together.	ris
Splice the 3th letter of "qualify", the 5th letter of "mosquito", and the 1st letter of "grave" together.	aug
Splice the 8th letter of "represent", the 3th letter of "grave", and the 8th letter of "neighbour" together.	nau
Splice the 5th letter of "acute", the 3th letter of "manual", and the 6th letter of "eighth" together.	enh
Splice the 4th letter of "phase", the 5th letter of "ladder", and the 4th letter of "coin" together.	sen
Splice the 7th letter of "confirm", the 2rd letter of "possess", and the 4th letter of "involve" together.	moo
Splice the 4th letter of "college", the 3th letter of "college", and the 5th letter of "shade" together.	lle
Splice the 4th letter of "hook", the 1st letter of "mate", and the 1st letter of "lean" together.	kml
Splice the 5th letter of "shade", the 1st letter of "each", and the 1st letter of "matter" together.	eem
Splice the 1st letter of "attitude", the 4th letter of "accident", and the 2rd letter of "neighbour" together.	aie
Splice the 1st letter of "lean", the 3th letter of "card", and the 3th letter of "mosquito" together.	lrs
Splice the 2rd letter of "accident", the 8th letter of "president", and the 5th letter of "butcher" together.	cnh
Splice the 2rd letter of "represent", the 2rd letter of "possess", and the 1st letter of "represent" together.	eor
Splice the 7th letter of "explore", the 6th letter of "college", and the 5th letter of "whoever" together.	egv
Splice the 1st letter of "whoever", the 8th letter of "radiation", and the 4th letter of "about" together.	wou
Splice the 6th letter of "recover", the 3th letter of "sleep", and the 3th letter of "mate" together.	eet
Splice the 3th letter of "each", the 4th letter of "spur", and the 6th letter of "neighbour" together.	crb
Splice the 1st letter of "sugar", the 1st letter of "follow", and the 2rd letter of "radiation" together.	sfa
Splice the 2rd letter of "hear", the 1st letter of "spur", and the 6th letter of "possess" together.	ess
Splice the 5th letter of "tomato", the 1st letter of "lean", and the 4th letter of "evil" together.	tll
Splice the 4th letter of "supper", the 8th letter of "elevator", and the 2rd letter of "greeting" together.	prr
Splice the 1st letter of "float", the 4th letter of "evil", and the 3th letter of "soap" together.	fla
Splice the 2rd letter of "hope", the 5th letter of "represent", and the 5th letter of "plough" together.	oeg
Splice the 2rd letter of "navy", the 3th letter of "insect", and the 2rd letter of "mosquito" together.	aso
Splice the 3th letter of "evil", the 3th letter of "explosion", and the 3th letter of "ought" together.	ipg
Splice the 4th letter of "phase", the 2rd letter of "follow", and the 1st letter of "gown" together.	sog
Splice the 4th letter of "born", the 4th letter of "plough", and the 2rd letter of "gown" together.	nuo
Splice the 4th letter of "Asian", the 3th letter of "sugar", and the 3th letter of "hook" together.	ago
Splice the 7th letter of "possess", the 2rd letter of "matter", and the 2rd letter of "dispose" together.	sai
Splice the 6th letter of "familiar", the 6th letter of "manual", and the 2rd letter of "Asian" together.	ils
Splice the 2rd letter of "pull", the 2rd letter of "acute", and the 7th letter of "district" together.	ucc
Splice the 3th letter of "class", the 4th letter of "official", and the 2rd letter of "story" together.	ait
Splice the 2rd letter of "hope", the 3th letter of "security", and the 1st letter of "neighbour" together.	ocn
Splice the 8th letter of "district", the 2rd letter of "about", and the 8th letter of "velocity" together.	tby
Splice the 8th letter of "greeting", the 3th letter of "ought", and the 4th letter of "sugar" together.	gga
Splice the 6th letter of "follow", the 1st letter of "atomic", and the 2rd letter of "Communism" together.	wao
Splice the 8th letter of "statement", the 7th letter of "popular", and the 1st letter of "file" together.	nrf
Splice the 4th letter of "mouse", the 5th letter of "anger", and the 1st letter of "navy" together.	srn
Splice the 2rd letter of "laundry", the 4th letter of "center", and the 1st letter of "acute" together.	ata
Splice the 1st letter of "matter", the 3th letter of "file", and the 4th letter of "gown" together.	mln
Splice the 5th letter of "follow", the 5th letter of "atomic", and the 3th letter of "shade" together.	oia
Splice the 4th letter of "evil", the 4th letter of "card", and the 4th letter of "familiar" together.	ldi
Splice the 3th letter of "gown", the 2rd letter of "card", and the 1st letter of "accident" together.	waa
Splice the 1st letter of "about", the 7th letter of "neglect", and the 7th letter of "accident" together.	atn
Splice the 2rd letter of "qualify", the 3th letter of "hook", and the 1st letter of "neglect" together.	uon
Splice the 1st letter of "lumber", the 1st letter of "pull", and the 5th letter of "explore" together.	lpo
Splice the 3th letter of "district", the 2rd letter of "neighbour", and the 9th letter of "explosion" together.	sen
Splice the 1st letter of "dispose", the 2rd letter of "sleep", and the 1st letter of "prior" together.	dlp
Splice the 4th letter of "file", the 7th letter of "accident", and the 2rd letter of "rival" together.	eni
Splice the 1st letter of "laundry", the 2rd letter of "reed", and the 3th letter of "career" together.	ler
Splice the 4th letter of "hook", the 2rd letter of "mouse", and the 5th letter of "grave" together.	koe
Splice the 2rd letter of "sugar", the 6th letter of "insect", and the 5th letter of "shriek" together.	ute
Splice the 4th letter of "lean", the 6th letter of "retain", and the 7th letter of "butcher" together.	nnr
Splice the 3th letter of "coin", the 5th letter of "float", and the 4th letter of "each" together.	ith
Splice the 2rd letter of "shade", the 4th letter of "mouse", and the 1st letter of "district" together.	hsd
Splice the 3th letter of "class", the 8th letter of "contrast", and the 3th letter of "statement" together.	ata
Splice the 4th letter of "Communism", the 4th letter of "anger", and the 7th letter of "illegal" together.	mel
Splice the 2rd letter of "attitude", the 6th letter of "hardware", and the 2rd letter of "popular" together.	tao
Splice the 3th letter of "Communism", the 1st letter of "rabbit", and the 5th letter of "sleep" together.	mrp
Splice the 8th letter of "mosquito", the 3th letter of "story", and the 1st letter of "sleep" together.	oos
Splice the 6th letter of "lumber", the 8th letter of "president", and the 3th letter of "Communism" together.	rnm
Splice the 1st letter of "ought", the 5th letter of "hardly", and the 6th letter of "tomato" together.	olo
Splice the 4th letter of "each", the 5th letter of "greeting", and the 4th letter of "Asian" together.	hta
Splice the 2rd letter of "tomato", the 1st letter of "ladder", and the 5th letter of "tablet" together.	ole
Splice the 4th letter of "shade", the 1st letter of "sugar", and the 3th letter of "prior" together.	dsi
Splice the 2rd letter of "outlet", the 2rd letter of "joint", and the 9th letter of "radiation" together.	uon
Splice the 2rd letter of "evil", the 2rd letter of "hope", and the 7th letter of "involve" together.	voe
Splice the 2rd letter of "write", the 6th letter of "manual", and the 4th letter of "phase" together.	rls
Splice the 4th letter of "shady", the 2rd letter of "insect", and the 5th letter of "explore" together.	dno
Splice the 1st letter of "navy", the 4th letter of "grave", and the 2rd letter of "born" together.	nvo
Splice the 2rd letter of "mate", the 1st letter of "float", and the 1st letter of "evil" together.	afe
Splice the 2rd letter of "neglect", the 3th letter of "violet", and the 5th letter of "turbulent" together.	eou
Splice the 4th letter of "India", the 2rd letter of "Canada", and the 1st letter of "qualify" together.	iaq
Splice the 1st letter of "whoever", the 3th letter of "radiation", and the 4th letter of "evil" together.	wdl
Splice the 1st letter of "contrast", the 2rd letter of "Communism", and the 1st letter of "dispose" together.	cod
Splice the 2rd letter of "statement", the 7th letter of "involve", and the 3th letter of "lean" together.	tea
Splice the 2rd letter of "supper", the 4th letter of "pull", and the 4th letter of "recover" together.	ulo
Splice the 5th letter of "ought", the 1st letter of "rival", and the 4th letter of "hook" together.	trk
Splice the 2rd letter of "elevator", the 5th letter of "matter", and the 4th letter of "ever" together.	ler
Splice the 1st letter of "Asian", the 5th letter of "statement", and the 6th letter of "plough" together.	Aeh
Splice the 2rd letter of "sometime", the 1st letter of "sleep", and the 4th letter of "district" together.	ost
Splice the 3th letter of "outlet", the 4th letter of "hope", and the 6th letter of "hardware" together.	tea
Splice the 5th letter of "atomic", the 6th letter of "attitude", and the 4th letter of "entrance" together.	iur
Splice the 3th letter of "tablet", the 5th letter of "turnip", and the 5th letter of "college" together.	bie
Splice the 2rd letter of "explore", the 8th letter of "security", and the 4th letter of "lean" together.	xyn
Splice the 4th letter of "accident", the 3th letter of "attitude", and the 2rd letter of "evil" together.	itv
Splice the 5th letter of "turbulent", the 1st letter of "gown", and the 2rd letter of "born" together.	ugo
Splice the 3th letter of "insect", the 6th letter of "gymnasium", and the 6th letter of "college" together.	ssg
Splice the 3th letter of "born", the 9th letter of "Communism", and the 4th letter of "shriek" together.	rmi
Splice the 3th letter of "explosion", the 7th letter of "mosquito", and the 2rd letter of "visible" together.	pti
Splice the 4th letter of "accident", the 4th letter of "soap", and the 2rd letter of "broken" together.	ipr
Splice the 5th letter of "supper", the 6th letter of "greeting", and the 4th letter of "write" together.	eit
Splice the 5th letter of "violet", the 5th letter of "whoever", and the 7th letter of "president" together.	eve
Splice the 5th letter of "dispose", the 5th letter of "outlet", and the 2rd letter of "pull" together.	oeu
Splice the 7th letter of "gymnasium", the 6th letter of "sometime", and the 5th letter of "around" together.	iin
Splice the 4th letter of "about", the 7th letter of "explosion", and the 3th letter of "hardware" together.	uir
Splice the 2rd letter of "matter", the 2rd letter of "radiation", and the 1st letter of "tablet" together.	aat
Splice the 3th letter of "illegal", the 5th letter of "president", and the 5th letter of "shade" together.	lie
Splice the 1st letter of "lumber", the 2rd letter of "file", and the 7th letter of "mosquito" together.	lit
Splice the 6th letter of "mosquito", the 5th letter of "float", and the 3th letter of "accident" together.	itc
Splice the 4th letter of "grave", the 3th letter of "spur", and the 1st letter of "mate" together.	vum
Splice the 4th letter of "sometime", the 5th letter of "grave", and the 2rd letter of "center" together.	eee
Splice the 5th letter of "class", the 1st letter of "ever", and the 2rd letter of "born" together.	seo
Splice the 8th letter of "Communism", the 6th letter of "turbulent", and the 5th letter of "recover" together.	slv
Splice the 9th letter of "neighbour", the 6th letter of "whoever", and the 2rd letter of "eighth" together.	rei
Splice the 3th letter of "ought", the 4th letter of "violet", and the 7th letter of "contrast" together.	gls
Splice the 1st letter of "born", the 3th letter of "accident", and the 6th letter of "illegal" together.	bca
Splice the 1st letter of "each", the 2rd letter of "grave", and the 4th letter of "each" together.	erh
Splice the 7th letter of "possess", the 2rd letter of "whoever", and the 6th letter of "explore" together.	shr
Splice the 2rd letter of "shady", the 2rd letter of "possess", and the 3th letter of "India" together.	hod
Splice the 3th letter of "radiation", the 1st letter of "dispose", and the 3th letter of "outlet" together.	ddt
Splice the 1st letter of "file", the 4th letter of "president", and the 6th letter of "explosion" together.	fss
Splice the 2rd letter of "contrast", the 6th letter of "mosquito", and the 7th letter of "dispose" together.	oie
Splice the 7th letter of "explosion", the 2rd letter of "contrast", and the 2rd letter of "laundry" together.	ioa
Splice the 2rd letter of "ever", the 6th letter of "career", and the 1st letter of "gymnasium" together.	vrg
Splice the 4th letter of "explosion", the 3th letter of "explore", and the 2rd letter of "center" together.	lpe
Splice the 2rd letter of "sometime", the 5th letter of "turnip", and the 7th letter of "attitude" together.	oid
Splice the 9th letter of "explosion", the 3th letter of "shady", and the 3th letter of "joint" together.	nai
Splice the 3th letter of "lumber", the 3th letter of "manual", and the 3th letter of "prior" together.	mni
Splice the 5th letter of "shady", the 7th letter of "neglect", and the 2rd letter of "shade" together.	yth
Splice the 3th letter of "atomic", the 1st letter of "entrance", and the 2rd letter of "class" together.	oel
Splice the 3th letter of "dispose", the 5th letter of "outlet", and the 2rd letter of "class" together.	sel
Splice the 4th letter of "visible", the 4th letter of "center", and the 5th letter of "butcher" together.	ith
Splice the 4th letter of "about", the 7th letter of "sometime", and the 3th letter of "born" together.	umr
Splice the 1st letter of "ladder", the 3th letter of "velocity", and the 4th letter of "evil" together.	lll
Splice the 2rd letter of "grave", the 3th letter of "joint", and the 5th letter of "mosquito" together.	riu
Splice the 5th letter of "shady", the 4th letter of "qualify", and the 2rd letter of "reed" together.	yle
Splice the 1st letter of "hear", the 3th letter of "plough", and the 1st letter of "navy" together.	hon
Splice the 5th letter of "Canada", the 2rd letter of "explosion", and the 3th letter of "grave" together.	dxa
Splice the 3th letter of "ought", the 4th letter of "Asian", and the 3th letter of "possess" together.	gas
Splice the 1st letter of "coin", the 8th letter of "elevator", and the 1st letter of "about" together.	cra
Splice the 3th letter of "sugar", the 4th letter of "hardware", and the 3th letter of "qualify" together.	gda
Splice the 3th letter of "confirm", the 3th letter of "coin", and the 5th letter of "violet" together.	nie
Splice the 1st letter of "phase", the 1st letter of "grave", and the 1st letter of "whoever" together.	pgw
Splice the 6th letter of "whoever", the 2rd letter of "neglect", and the 5th letter of "plough" together.	eeg
Splice the 3th letter of "story", the 5th letter of "Communism", and the 1st letter of "security" together.	ous
Splice the 1st letter of "career", the 4th letter of "navy", and the 5th letter of "float" together.	cyt
Splice the 5th letter of "shade", the 5th letter of "neglect", and the 1st letter of "about" together.	eea
Splice the 4th letter of "lumber", the 3th letter of "represent", and the 6th letter of "official" together.	bpi
Splice the 5th letter of "dispose", the 2rd letter of "entrance", and the 1st letter of "velocity" together.	onv
Splice the 3th letter of "story", the 3th letter of "eighth", and the 5th letter of "float" together.	ogt
Splice the 3th letter of "file", the 6th letter of "lumber", and the 5th letter of "laundry" together.	lrd
Splice the 5th letter of "about", the 7th letter of "qualify", and the 4th letter of "grave" together.	tyv
Splice the 2rd letter of "rival", the 2rd letter of "file", and the 5th letter of "radiation" together.	iia
Splice the 6th letter of "sometime", the 5th letter of "insect", and the 2rd letter of "joint" together.	ico
Splice the 3th letter of "sleep", the 2rd letter of "class", and the 1st letter of "hardware" together.	elh
Splice the 7th letter of "entrance", the 3th letter of "coin", and the 2rd letter of "grave" together.	cir
Splice the 6th letter of "retain", the 2rd letter of "soap", and the 3th letter of "insect" together.	nos
Splice the 1st letter of "whoever", the 3th letter of "sugar", and the 5th letter of "shade" together.	wge
Splice the 4th letter of "broken", the 6th letter of "president", and the 5th letter of "gymnasium" together.	kda
Splice the 2rd letter of "illegal", the 3th letter of "radiation", and the 1st letter of "shady" together.	lds
Splice the 4th letter of "Canada", the 8th letter of "accident", and the 6th letter of "follow" together.	atw
Splice the 3th letter of "India", the 1st letter of "shade", and the 6th letter of "around" together.	dsd
Splice the 4th letter of "reed", the 5th letter of "acute", and the 2rd letter of "pull" together.	deu
Splice the 9th letter of "president", the 2rd letter of "turbulent", and the 3th letter of "ladder" together.	tud
Splice the 4th letter of "tablet", the 5th letter of "ought", and the 3th letter of "ought" together.	ltg
Splice the 8th letter of "radiation", the 4th letter of "shriek", and the 5th letter of "ought" together.	oit
Splice the 1st letter of "neighbour", the 1st letter of "anger", and the 1st letter of "pull" together.	nap
Splice the 3th letter of "lumber", the 3th letter of "explore", and the 1st letter of "contrast" together.	mpc
Splice the 3th letter of "velocity", the 4th letter of "possess", and the 1st letter of "shady" together.	lss
Splice the 5th letter of "shady", the 3th letter of "shady", and the 5th letter of "eighth" together.	yat
Splice the 5th letter of "explore", the 3th letter of "Communism", and the 2rd letter of "soap" together.	omo
Splice the 3th letter of "center", the 3th letter of "card", and the 4th letter of "involve" together.	nro
Splice the 4th letter of "broken", the 6th letter of "outlet", and the 6th letter of "tomato" together.	kto
Splice the 2rd letter of "illegal", the 5th letter of "confirm", and the 5th letter of "security" together.	lir
Splice the 2rd letter of "prior", the 6th letter of "greeting", and the 4th letter of "float" together.	ria
Splice the 2rd letter of "about", the 3th letter of "velocity", and the 3th letter of "rival" together.	blv
Splice the 4th letter of "file", the 3th letter of "retain", and the 2rd letter of "gown" together.	eto
Splice the 2rd letter of "joint", the 6th letter of "turnip", and the 2rd letter of "hardly" together.	opa
Splice the 3th letter of "supper", the 3th letter of "violet", and the 4th letter of "India" together.	poi
Splice the 5th letter of "gymnasium", the 1st letter of "hook", and the 3th letter of "gown" together.	ahw
Splice the 3th letter of "neighbour", the 3th letter of "Canada", and the 8th letter of "contrast" together.	int
Splice the 2rd letter of "gown", the 2rd letter of "each", and the 4th letter of "class" together.	oas
Splice the 4th letter of "hear", the 1st letter of "laundry", and the 3th letter of "acute" together.	rlu
Splice the 2rd letter of "explore", the 4th letter of "sleep", and the 7th letter of "official" together.	xea
Splice the 4th letter of "insect", the 6th letter of "turnip", and the 5th letter of "joint" together.	ept
Splice the 2rd letter of "gymnasium", the 1st letter of "phase", and the 1st letter of "sometime" together.	yps
Splice the 1st letter of "hear", the 4th letter of "butcher", and the 3th letter of "turnip" together.	hcr
Splice the 3th letter of "college", the 2rd letter of "soap", and the 2rd letter of "neglect" together.	loe
Splice the 1st letter of "soap", the 5th letter of "neighbour", and the 1st letter of "manual" together.	shm
Splice the 4th letter of "mate", the 7th letter of "radiation", and the 6th letter of "follow" together.	eiw
Splice the 4th letter of "violet", the 3th letter of "attitude", and the 1st letter of "file" together.	ltf
Splice the 2rd letter of "explore", the 3th letter of "navy", and the 3th letter of "spur" together.	xvu
Splice the 5th letter of "about", the 3th letter of "write", and the 2rd letter of "Asian" together.	tis
Splice the 1st letter of "qualify", the 2rd letter of "visible", and the 1st letter of "statement" together.	qis
Splice the 8th letter of "greeting", the 6th letter of "Canada", and the 7th letter of "college" together.	gae
Splice the 7th letter of "butcher", the 3th letter of "ever", and the 3th letter of "lumber" together.	rem
Splice the 1st letter of "soap", the 3th letter of "supper", and the 8th letter of "velocity" together.	spy
Splice the 1st letter of "about", the 3th letter of "whoever", and the 6th letter of "tablet" together.	aot
Splice the 8th letter of "gymnasium", the 5th letter of "accident", and the 5th letter of "rival" together.	udl
Splice the 1st letter of "hardly", the 1st letter of "around", and the 1st letter of "possess" together.	hap
Splice the 6th letter of "popular", the 1st letter of "retain", and the 5th letter of "shady" together.	ary
Splice the 1st letter of "card", the 6th letter of "possess", and the 2rd letter of "mate" together.	csa
Splice the 3th letter of "rival", the 2rd letter of "lumber", and the 1st letter of "velocity" together.	vuv
Splice the 4th letter of "file", the 5th letter of "attitude", and the 5th letter of "district" together.	etr
Splice the 3th letter of "class", the 1st letter of "mosquito", and the 3th letter of "lean" together.	ama
Splice the 1st letter of "supper", the 2rd letter of "file", and the 7th letter of "hardware" together.	sir
Splice the 3th letter of "possess", the 4th letter of "sugar", and the 7th letter of "neglect" together.	sat
Splice the 3th letter of "follow", the 2rd letter of "lean", and the 1st letter of "file" together.	lef
Splice the 4th letter of "center", the 5th letter of "college", and the 7th letter of "president" together.	tee
Splice the 7th letter of "confirm", the 9th letter of "gymnasium", and the 3th letter of "familiar" together.	mmm
Splice the 1st letter of "shade", the 6th letter of "center", and the 4th letter of "Canada" together.	sra
Splice the 4th letter of "explosion", the 4th letter of "plough", and the 5th letter of "anger" together.	lur
Splice the 6th letter of "neglect", the 3th letter of "spur", and the 1st letter of "mosquito" together.	cum
Splice the 6th letter of "confirm", the 5th letter of "explore", and the 1st letter of "about" together.	roa
Splice the 4th letter of "security", the 3th letter of "sleep", and the 1st letter of "eighth" together.	uee
Splice the 5th letter of "explosion", the 1st letter of "grave", and the 1st letter of "float" together.	ogf
Splice the 1st letter of "tablet", the 6th letter of "around", and the 2rd letter of "gown" together.	tdo
Splice the 4th letter of "confirm", the 4th letter of "evil", and the 2rd letter of "phase" together.	flh
Splice the 4th letter of "story", the 2rd letter of "illegal", and the 5th letter of "turbulent" together.	rlu
Splice the 1st letter of "familiar", the 6th letter of "laundry", and the 1st letter of "rabbit" together.	frr
Splice the 1st letter of "pull", the 1st letter of "tablet", and the 7th letter of "laundry" together.	pty
Splice the 3th letter of "dispose", the 1st letter of "ought", and the 4th letter of "hear" together.	sor
Splice the 6th letter of "manual", the 2rd letter of "reed", and the 2rd letter of "ever" together.	lev
Splice the 6th letter of "neglect", the 6th letter of "possess", and the 6th letter of "follow" together.	csw
Splice the 2rd letter of "sleep", the 4th letter of "coin", and the 6th letter of "gymnasium" together.	lns
Splice the 3th letter of "plough", the 2rd letter of "matter", and the 4th letter of "anger" together.	oae
Splice the 2rd letter of "hope", the 6th letter of "tablet", and the 3th letter of "shady" together.	ota
Splice the 1st letter of "neglect", the 2rd letter of "tablet", and the 4th letter of "retain" together.	naa
Splice the 1st letter of "official", the 4th letter of "rabbit", and the 6th letter of "district" together.	obi
Splice the 7th letter of "Communism", the 3th letter of "attitude", and the 7th letter of "security" together.	itt
Splice the 2rd letter of "matter", the 8th letter of "represent", and the 4th letter of "navy" together.	any
Splice the 6th letter of "lumber", the 3th letter of "sugar", and the 2rd letter of "manual" together.	rga
Splice the 3th letter of "India", the 1st letter of "broken", and the 3th letter of "turbulent" together.	dbr
Splice the 4th letter of "contrast", the 3th letter of "tomato", and the 2rd letter of "anger" together.	tmn
Splice the 3th letter of "sometime", the 7th letter of "turbulent", and the 3th letter of "India" together.	med
Splice the 4th letter of "neglect", the 3th letter of "each", and the 4th letter of "spur" together.	lcr
Splice the 2rd letter of "mate", the 3th letter of "around", and the 7th letter of "elevator" together.	aoo
Splice the 3th letter of "velocity", the 4th letter of "hope", and the 1st letter of "Asian" together.	leA
Splice the 3th letter of "hardware", the 5th letter of "shriek", and the 3th letter of "shade" together.	rea
Splice the 1st letter of "eighth", the 5th letter of "broken", and the 5th letter of "plough" together.	eeg
Splice the 7th letter of "explore", the 5th letter of "elevator", and the 3th letter of "lean" together.	eaa
Splice the 1st letter of "college", the 1st letter of "India", and the 1st letter of "born" together.	cIb
Splice the 3th letter of "dispose", the 5th letter of "turnip", and the 1st letter of "each" together.	sie
Splice the 4th letter of "soap", the 8th letter of "turbulent", and the 4th letter of "story" together.	pnr
Splice the 4th letter of "college", the 4th letter of "sugar", and the 1st letter of "evil" together.	lae
Splice the 6th letter of "broken", the 5th letter of "anger", and the 4th letter of "navy" together.	nry
Splice the 1st letter of "navy", the 2rd letter of "sometime", and the 6th letter of "official" together.	noi
Splice the 6th letter of "follow", the 1st letter of "anger", and the 6th letter of "confirm" together.	war
Splice the 7th letter of "visible", the 1st letter of "ever", and the 3th letter of "broken" together.	eeo
Splice the 1st letter of "hear", the 7th letter of "elevator", and the 2rd letter of "spur" together.	hop
Splice the 4th letter of "violet", the 3th letter of "confirm", and the 2rd letter of "supper" together.	lnu
Splice the 1st letter of "write", the 4th letter of "shriek", and the 1st letter of "sleep" together.	wis
Splice the 7th letter of "recover", the 1st letter of "navy", and the 3th letter of "shady" together.	rna
Splice the 5th letter of "attitude", the 4th letter of "plough", and the 3th letter of "soap" together.	tua
Splice the 6th letter of "plough", the 1st letter of "acute", and the 3th letter of "outlet" together.	hat
Splice the 5th letter of "violet", the 4th letter of "mouse", and the 3th letter of "district" together.	ess
Splice the 5th letter of "around", the 5th letter of "statement", and the 2rd letter of "explore" together.	nex
Splice the 4th letter of "eighth", the 3th letter of "ought", and the 4th letter of "each" together.	hgh
Splice the 4th letter of "president", the 1st letter of "security", and the 4th letter of "ever" together.	ssr
Splice the 2rd letter of "tomato", the 2rd letter of "career", and the 4th letter of "center" together.	oat
Splice the 5th letter of "recover", the 4th letter of "prior", and the 1st letter of "rival" together.	vor
Splice the 5th letter of "insect", the 2rd letter of "hear", and the 1st letter of "each" together.	cee
Splice the 1st letter of "violet", the 3th letter of "joint", and the 1st letter of "career" together.	vic
Splice the 1st letter of "outlet", the 7th letter of "hardware", and the 1st letter of "phase" together.	orp
Splice the 3th letter of "sleep", the 2rd letter of "security", and the 7th letter of "college" together.	eee
Splice the 3th letter of "district", the 5th letter of "matter", and the 1st letter of "supper" together.	ses
Splice the 3th letter of "coin", the 3th letter of "lumber", and the 3th letter of "about" together.	imo
Splice the 2rd letter of "dispose", the 8th letter of "mosquito", and the 5th letter of "center" together.	ioe
Splice the 2rd letter of "neglect", the 4th letter of "prior", and the 7th letter of "mosquito" together.	eot
Splice the 8th letter of "radiation", the 4th letter of "matter", and the 4th letter of "entrance" together.	otr
Splice the 3th letter of "evil", the 4th letter of "India", and the 1st letter of "laundry" together.	iil
Splice the 4th letter of "district", the 8th letter of "elevator", and the 2rd letter of "laundry" together.	tra
Splice the 7th letter of "neglect", the 1st letter of "whoever", and the 4th letter of "card" together.	twd
Splice the 3th letter of "phase", the 2rd letter of "sleep", and the 1st letter of "insect" together.	ali
Splice the 2rd letter of "statement", the 6th letter of "manual", and the 1st letter of "joint" together.	tlj
Splice the 2rd letter of "accident", the 1st letter of "matter", and the 6th letter of "eighth" together.	cmh
Splice the 6th letter of "mosquito", the 3th letter of "Canada", and the 7th letter of "attitude" together.	ind
Splice the 6th letter of "manual", the 2rd letter of "about", and the 2rd letter of "turbulent" together.	lbu
Splice the 1st letter of "mouse", the 3th letter of "whoever", and the 6th letter of "mosquito" together.	moi
Splice the 1st letter of "evil", the 1st letter of "familiar", and the 5th letter of "eighth" together.	eft
Splice the 1st letter of "rabbit", the 1st letter of "broken", and the 2rd letter of "possess" together.	rbo
Splice the 1st letter of "story", the 3th letter of "whoever", and the 4th letter of "pull" together.	sol
Splice the 3th letter of "class", the 1st letter of "coin", and the 5th letter of "shade" together.	ace
Splice the 4th letter of "coin", the 1st letter of "lean", and the 1st letter of "evil" together.	nle
Splice the 2rd letter of "violet", the 1st letter of "shade", and the 2rd letter of "Canada" together.	isa
Splice the 6th letter of "district", the 1st letter of "mate", and the 9th letter of "turbulent" together.	imt
Splice the 5th letter of "accident", the 2rd letter of "Communism", and the 1st letter of "matter" together.	dom
Splice the 2rd letter of "gymnasium", the 4th letter of "navy", and the 4th letter of "acute" together.	yyt
Splice the 5th letter of "sleep", the 2rd letter of "spur", and the 1st letter of "broken" together.	ppb
Splice the 5th letter of "rabbit", the 6th letter of "retain", and the 7th letter of "attitude" together.	ind
Splice the 4th letter of "tablet", the 4th letter of "whoever", and the 1st letter of "about" together.	lea
Splice the 6th letter of "turbulent", the 1st letter of "file", and the 2rd letter of "outlet" together.	lfu
Splice the 9th letter of "neighbour", the 2rd letter of "shade", and the 1st letter of "ought" together.	rho
Splice the 5th letter of "eighth", the 7th letter of "neglect", and the 5th letter of "outlet" together.	tte
Splice the 5th letter of "atomic", the 6th letter of "involve", and the 1st letter of "outlet" together.	ivo
Splice the 3th letter of "lumber", the 6th letter of "security", and the 2rd letter of "hope" together.	mio
Splice the 1st letter of "India", the 6th letter of "butcher", and the 6th letter of "rabbit" together.	Iet
Splice the 4th letter of "class", the 6th letter of "tomato", and the 2rd letter of "broken" together.	sor
Splice the 8th letter of "radiation", the 6th letter of "rabbit", and the 2rd letter of "velocity" together.	ote
Splice the 5th letter of "class", the 1st letter of "file", and the 7th letter of "sometime" together.	sfm
Splice the 6th letter of "outlet", the 5th letter of "tomato", and the 1st letter of "prior" together.	ttp
Splice the 2rd letter of "turbulent", the 9th letter of "statement", and the 3th letter of "accident" together.	utc
Splice the 2rd letter of "whoever", the 1st letter of "elevator", and the 3th letter of "matter" together.	het
Splice the 5th letter of "write", the 5th letter of "eighth", and the 5th letter of "security" together.	etr
Splice the 5th letter of "tomato", the 4th letter of "dispose", and the 4th letter of "violet" together.	tpl
Splice the 4th letter of "center", the 3th letter of "lumber", and the 4th letter of "hope" together.	tme
Splice the 1st letter of "statement", the 5th letter of "contrast", and the 5th letter of "about" together.	srt
Splice the 3th letter of "radiation", the 5th letter of "mosquito", and the 2rd letter of "outlet" together.	duu
Splice the 2rd letter of "involve", the 8th letter of "statement", and the 4th letter of "district" together.	nnt
Splice the 4th letter of "sleep", the 7th letter of "college", and the 1st letter of "shady" together.	ees
Splice the 2rd letter of "evil", the 3th letter of "gymnasium", and the 4th letter of "dispose" together.	vmp
Splice the 1st letter of "entrance", the 6th letter of "explore", and the 8th letter of "turbulent" together.	ern
Splice the 1st letter of "qualify", the 3th letter of "visible", and the 7th letter of "visible" together.	qse
Splice the 5th letter of "laundry", the 3th letter of "spur", and the 2rd letter of "accident" together.	duc
Splice the 2rd letter of "acute", the 5th letter of "entrance", and the 6th letter of "dispose" together.	cas
Splice the 3th letter of "retain", the 3th letter of "grave", and the 4th letter of "India" together.	tai
Splice the 4th letter of "whoever", the 2rd letter of "Canada", and the 4th letter of "ever" together.	ear
Splice the 2rd letter of "around", the 4th letter of "elevator", and the 2rd letter of "career" together.	rva
Splice the 4th letter of "mosquito", the 6th letter of "attitude", and the 5th letter of "prior" together.	qur
Splice the 1st letter of "mate", the 1st letter of "hear", and the 3th letter of "hook" together.	mho
Splice the 2rd letter of "India", the 1st letter of "hardware", and the 6th letter of "elevator" together.	nht
Splice the 6th letter of "confirm", the 4th letter of "sugar", and the 3th letter of "pull" together.	ral
Splice the 4th letter of "velocity", the 3th letter of "each", and the 3th letter of "prior" together.	oci
Splice the 1st letter of "neglect", the 4th letter of "greeting", and the 4th letter of "supper" together.	nep
Splice the 2rd letter of "accident", the 5th letter of "entrance", and the 1st letter of "recover" together.	car
Splice the 3th letter of "file", the 2rd letter of "attitude", and the 7th letter of "butcher" together.	ltr
Splice the 3th letter of "sometime", the 5th letter of "rabbit", and the 4th letter of "write" together.	mit
Splice the 4th letter of "atomic", the 5th letter of "phase", and the 4th letter of "official" together.	mei
Splice the 3th letter of "hope", the 8th letter of "greeting", and the 6th letter of "violet" together.	pgt
Splice the 2rd letter of "hear", the 2rd letter of "prior", and the 2rd letter of "mate" together.	era
Splice the 1st letter of "hardly", the 4th letter of "shady", and the 2rd letter of "pull" together.	hdu
Splice the 4th letter of "possess", the 6th letter of "explore", and the 4th letter of "dispose" together.	srp
Splice the 6th letter of "recover", the 4th letter of "shade", and the 5th letter of "accident" together.	edd
Splice the 4th letter of "rabbit", the 5th letter of "statement", and the 3th letter of "each" together.	bec
Splice the 1st letter of "follow", the 3th letter of "spur", and the 4th letter of "ought" together.	fuh
Splice the 2rd letter of "ought", the 1st letter of "shade", and the 8th letter of "represent" together.	usn
Splice the 1st letter of "story", the 8th letter of "hardware", and the 1st letter of "ladder" together.	sel
Splice the 4th letter of "about", the 4th letter of "evil", and the 1st letter of "mate" together.	ulm
Splice the 3th letter of "navy", the 5th letter of "India", and the 7th letter of "president" together.	vae
Splice the 5th letter of "elevator", the 1st letter of "neglect", and the 2rd letter of "plough" together.	anl
Splice the 4th letter of "mate", the 1st letter of "qualify", and the 1st letter of "Asian" together.	eqA
Splice the 3th letter of "prior", the 1st letter of "sometime", and the 3th letter of "statement" together.	isa
Splice the 4th letter of "file", the 2rd letter of "spur", and the 7th letter of "attitude" together.	epd
Splice the 3th letter of "follow", the 6th letter of "Communism", and the 2rd letter of "born" together.	lno
Splice the 3th letter of "popular", the 1st letter of "gymnasium", and the 3th letter of "mouse" together.	pgu
Splice the 3th letter of "laundry", the 3th letter of "recover", and the 6th letter of "career" together.	ucr
Splice the 6th letter of "radiation", the 5th letter of "shady", and the 6th letter of "statement" together.	tym
Splice the 1st letter of "insect", the 3th letter of "spur", and the 5th letter of "tablet" together.	iue
Splice the 7th letter of "popular", the 4th letter of "entrance", and the 4th letter of "entrance" together.	rrr
Splice the 3th letter of "joint", the 6th letter of "atomic", and the 4th letter of "attitude" together.	ici
Splice the 7th letter of "dispose", the 8th letter of "hardware", and the 1st letter of "familiar" together.	eef
Splice the 5th letter of "shade", the 4th letter of "career", and the 3th letter of "gown" together.	eew
Splice the 5th letter of "explosion", the 1st letter of "phase", and the 1st letter of "hear" together.	oph
Splice the 6th letter of "popular", the 3th letter of "plough", and the 5th letter of "class" together.	aos
Splice the 3th letter of "dispose", the 1st letter of "each", and the 5th letter of "about" together.	set
Splice the 4th letter of "write", the 5th letter of "write", and the 2rd letter of "ever" together.	tev
Splice the 1st letter of "Asian", the 5th letter of "familiar", and the 3th letter of "insect" together.	Als
Splice the 1st letter of "phase", the 7th letter of "illegal", and the 2rd letter of "about" together.	plb
Splice the 6th letter of "tomato", the 4th letter of "center", and the 6th letter of "mosquito" together.	oti
Splice the 2rd letter of "violet", the 9th letter of "president", and the 5th letter of "radiation" together.	ita
Splice the 3th letter of "grave", the 7th letter of "represent", and the 3th letter of "neglect" together.	aeg
Splice the 8th letter of "contrast", the 2rd letter of "president", and the 4th letter of "elevator" together.	trv
Splice the 3th letter of "phase", the 3th letter of "follow", and the 5th letter of "atomic" together.	ali
Splice the 2rd letter of "sometime", the 7th letter of "college", and the 3th letter of "India" together.	oed
Splice the 2rd letter of "represent", the 3th letter of "hope", and the 2rd letter of "mouse" together.	epo
Splice the 5th letter of "around", the 8th letter of "neighbour", and the 4th letter of "radiation" together.	nui
Splice the 1st letter of "visible", the 4th letter of "pull", and the 3th letter of "ought" together.	vlg
Splice the 1st letter of "evil", the 1st letter of "entrance", and the 4th letter of "shady" together.	eed
Splice the 2rd letter of "lumber", the 1st letter of "hope", and the 7th letter of "college" together.	uhe
Splice the 6th letter of "familiar", the 4th letter of "prior", and the 4th letter of "elevator" together.	iov
Splice the 2rd letter of "anger", the 6th letter of "laundry", and the 8th letter of "sometime" together.	nre
Splice the 5th letter of "greeting", the 4th letter of "shady", and the 5th letter of "violet" together.	tde
Splice the 2rd letter of "grave", the 4th letter of "anger", and the 3th letter of "hook" together.	reo
Splice the 4th letter of "follow", the 4th letter of "career", and the 4th letter of "hope" together.	lee
Splice the 2rd letter of "hear", the 6th letter of "whoever", and the 9th letter of "represent" together.	eet
Splice the 6th letter of "shriek", the 6th letter of "attitude", and the 3th letter of "pull" together.	kul
Splice the 5th letter of "visible", the 3th letter of "attitude", and the 5th letter of "tomato" together.	btt
Splice the 7th letter of "mosquito", the 2rd letter of "follow", and the 1st letter of "file" together.	tof
Splice the 4th letter of "elevator", the 7th letter of "accident", and the 4th letter of "card" together.	vnd
Splice the 4th letter of "hear", the 2rd letter of "mouse", and the 2rd letter of "soap" together.	roo
Splice the 3th letter of "around", the 1st letter of "hardware", and the 2rd letter of "grave" together.	ohr
Splice the 1st letter of "class", the 4th letter of "retain", and the 5th letter of "shade" together.	cae
Splice the 4th letter of "around", the 4th letter of "born", and the 1st letter of "evil" together.	une
Splice the 8th letter of "district", the 4th letter of "around", and the 5th letter of "retain" together.	tui
Splice the 2rd letter of "prior", the 1st letter of "hardly", and the 7th letter of "turbulent" together.	rhe
Splice the 2rd letter of "statement", the 5th letter of "accident", and the 4th letter of "eighth" together.	tdh
Splice the 2rd letter of "hardware", the 2rd letter of "atomic", and the 4th letter of "popular" together.	atu
Splice the 2rd letter of "about", the 9th letter of "gymnasium", and the 4th letter of "hardly" together.	bmd
Splice the 2rd letter of "evil", the 4th letter of "hope", and the 1st letter of "anger" together.	vea
Splice the 4th letter of "file", the 4th letter of "explore", and the 2rd letter of "explosion" together.	elx
Splice the 6th letter of "popular", the 4th letter of "tomato", and the 4th letter of "contrast" together.	aat
Splice the 7th letter of "familiar", the 5th letter of "class", and the 2rd letter of "official" together.	asf
Splice the 4th letter of "popular", the 3th letter of "laundry", and the 4th letter of "acute" together.	uut
Splice the 4th letter of "qualify", the 3th letter of "grave", and the 3th letter of "around" together.	lao
Splice the 4th letter of "India", the 1st letter of "matter", and the 1st letter of "entrance" together.	ime
Splice the 4th letter of "lean", the 6th letter of "velocity", and the 4th letter of "hope" together.	nie
Splice the 1st letter of "anger", the 6th letter of "represent", and the 6th letter of "confirm" together.	asr
Splice the 4th letter of "mosquito", the 7th letter of "mosquito", and the 3th letter of "visible" together.	qts
Splice the 3th letter of "ever", the 4th letter of "familiar", and the 4th letter of "evil" together.	eil
Splice the 4th letter of "eighth", the 4th letter of "around", and the 3th letter of "India" together.	hud
Splice the 5th letter of "matter", the 5th letter of "Asian", and the 4th letter of "sugar" together.	ena
Splice the 4th letter of "joint", the 5th letter of "hardly", and the 5th letter of "mouse" together.	nle
Splice the 1st letter of "gown", the 3th letter of "joint", and the 6th letter of "tomato" together.	gio
Splice the 6th letter of "follow", the 5th letter of "grave", and the 1st letter of "follow" together.	wef
Splice the 3th letter of "involve", the 3th letter of "ever", and the 5th letter of "center" together.	vee
Splice the 6th letter of "Communism", the 3th letter of "mosquito", and the 1st letter of "retain" together.	nsr
Splice the 1st letter of "sugar", the 5th letter of "shriek", and the 6th letter of "tablet" together.	set
Splice the 1st letter of "pull", the 1st letter of "velocity", and the 2rd letter of "spur" together.	pvp
Splice the 4th letter of "attitude", the 2rd letter of "college", and the 4th letter of "float" together.	ioa
Splice the 3th letter of "reed", the 6th letter of "turnip", and the 3th letter of "gymnasium" together.	epm
Splice the 8th letter of "president", the 2rd letter of "radiation", and the 2rd letter of "mate" together.	naa
Splice the 6th letter of "lumber", the 6th letter of "follow", and the 6th letter of "insect" together.	rwt
Splice the 2rd letter of "broken", the 3th letter of "ought", and the 4th letter of "neighbour" together.	rgg
Splice the 3th letter of "outlet", the 2rd letter of "each", and the 5th letter of "lumber" together.	tae
Splice the 1st letter of "dispose", the 7th letter of "hardware", and the 3th letter of "born" together.	drr
Splice the 5th letter of "radiation", the 4th letter of "qualify", and the 3th letter of "security" together.	alc
Splice the 1st letter of "neglect", the 4th letter of "sugar", and the 1st letter of "sleep" together.	nas
Splice the 1st letter of "born", the 1st letter of "insect", and the 1st letter of "each" together.	bie
Splice the 4th letter of "write", the 4th letter of "president", and the 2rd letter of "explore" together.	tsx
Splice the 4th letter of "tomato", the 1st letter of "neglect", and the 2rd letter of "outlet" together.	anu
Splice the 5th letter of "qualify", the 6th letter of "security", and the 3th letter of "whoever" together.	iio
Splice the 3th letter of "explosion", the 1st letter of "broken", and the 3th letter of "write" together.	pbi
Splice the 1st letter of "matter", the 2rd letter of "shady", and the 6th letter of "retain" together.	mhn
Splice the 1st letter of "soap", the 1st letter of "each", and the 5th letter of "phase" together.	see
Splice the 4th letter of "ought", the 2rd letter of "sleep", and the 2rd letter of "manual" together.	hla
Splice the 4th letter of "prior", the 4th letter of "Canada", and the 3th letter of "phase" together.	oaa
Splice the 9th letter of "statement", the 2rd letter of "hardware", and the 8th letter of "represent" together.	tan
Splice the 3th letter of "acute", the 3th letter of "greeting", and the 1st letter of "radiation" together.	uer
Splice the 4th letter of "soap", the 3th letter of "manual", and the 4th letter of "mate" together.	pne
Splice the 1st letter of "grave", the 2rd letter of "atomic", and the 4th letter of "shriek" together.	gti
Splice the 1st letter of "involve", the 4th letter of "tomato", and the 5th letter of "tablet" together.	iae
Splice the 2rd letter of "district", the 6th letter of "violet", and the 7th letter of "qualify" together.	ity
Splice the 4th letter of "about", the 3th letter of "pull", and the 1st letter of "each" together.	ule
Splice the 6th letter of "dispose", the 1st letter of "file", and the 2rd letter of "career" together.	sfa
Splice the 1st letter of "each", the 2rd letter of "each", and the 4th letter of "district" together.	eat
Splice the 1st letter of "hear", the 1st letter of "sugar", and the 3th letter of "tablet" together.	hsb
Splice the 2rd letter of "mate", the 2rd letter of "reed", and the 7th letter of "explosion" together.	aei
Splice the 4th letter of "mosquito", the 2rd letter of "president", and the 3th letter of "lean" together.	qra
Splice the 4th letter of "hardly", the 2rd letter of "reed", and the 4th letter of "follow" together.	del
Splice the 5th letter of "story", the 5th letter of "explosion", and the 4th letter of "gown" together.	yon
Splice the 5th letter of "tablet", the 8th letter of "familiar", and the 7th letter of "attitude" together.	erd
Splice the 4th letter of "president", the 5th letter of "follow", and the 7th letter of "explosion" together.	soi
Splice the 7th letter of "laundry", the 4th letter of "security", and the 5th letter of "recover" together.	yuv
Splice the 4th letter of "ever", the 4th letter of "security", and the 3th letter of "sleep" together.	rue
Splice the 5th letter of "hardware", the 2rd letter of "hardware", and the 2rd letter of "each" together.	waa
Splice the 1st letter of "violet", the 1st letter of "born", and the 5th letter of "Canada" together.	vbd
Splice the 3th letter of "grave", the 4th letter of "each", and the 6th letter of "tomato" together.	aho
Splice the 5th letter of "qualify", the 3th letter of "tablet", and the 3th letter of "lumber" together.	ibm
Splice the 5th letter of "gymnasium", the 3th letter of "center", and the 8th letter of "statement" together.	ann
Splice the 1st letter of "navy", the 4th letter of "hook", and the 5th letter of "explore" together.	nko
Splice the 6th letter of "supper", the 7th letter of "velocity", and the 6th letter of "attitude" together.	rtu
Splice the 8th letter of "contrast", the 4th letter of "mosquito", and the 1st letter of "familiar" together.	tqf
Splice the 6th letter of "hardly", the 1st letter of "whoever", and the 6th letter of "broken" together.	ywn
Splice the 3th letter of "visible", the 3th letter of "confirm", and the 1st letter of "possess" together.	snp
Splice the 3th letter of "mouse", the 4th letter of "ladder", and the 5th letter of "tomato" together.	udt
Splice the 2rd letter of "about", the 2rd letter of "neglect", and the 4th letter of "around" together.	beu
Splice the 7th letter of "visible", the 9th letter of "neighbour", and the 3th letter of "outlet" together.	ert
Splice the 8th letter of "attitude", the 3th letter of "elevator", and the 3th letter of "atomic" together.	eeo
Splice the 5th letter of "elevator", the 4th letter of "coin", and the 3th letter of "whoever" together.	ano
Splice the 2rd letter of "possess", the 1st letter of "gymnasium", and the 2rd letter of "sugar" together.	ogu
Splice the 4th letter of "acute", the 7th letter of "gymnasium", and the 5th letter of "mosquito" together.	tiu
Splice the 3th letter of "radiation", the 5th letter of "story", and the 1st letter of "ought" together.	dyo
Splice the 9th letter of "president", the 8th letter of "represent", and the 7th letter of "illegal" together.	tnl
Splice the 5th letter of "Communism", the 5th letter of "accident", and the 6th letter of "insect" together.	udt
Splice the 3th letter of "file", the 3th letter of "file", and the 4th letter of "radiation" together.	lli
Splice the 2rd letter of "mate", the 1st letter of "Asian", and the 5th letter of "illegal" together.	aAg
Splice the 1st letter of "each", the 5th letter of "insect", and the 3th letter of "hope" together.	ecp
Splice the 1st letter of "hardware", the 2rd letter of "file", and the 6th letter of "retain" together.	hin
Splice the 4th letter of "hope", the 2rd letter of "ladder", and the 4th letter of "card" together.	ead
Splice the 3th letter of "retain", the 4th letter of "follow", and the 3th letter of "hear" together.	tla
Splice the 2rd letter of "Communism", the 4th letter of "Asian", and the 3th letter of "manual" together.	oan
Splice the 1st letter of "neglect", the 7th letter of "qualify", and the 3th letter of "Communism" together.	nym
Splice the 6th letter of "turbulent", the 8th letter of "neighbour", and the 1st letter of "shady" together.	lus
Splice the 5th letter of "career", the 4th letter of "Asian", and the 5th letter of "familiar" together.	eal
Splice the 6th letter of "career", the 6th letter of "atomic", and the 2rd letter of "explosion" together.	rcx
Splice the 3th letter of "familiar", the 7th letter of "laundry", and the 5th letter of "float" together.	myt
Splice the 4th letter of "violet", the 2rd letter of "possess", and the 4th letter of "grave" together.	lov
Splice the 3th letter of "follow", the 1st letter of "lumber", and the 4th letter of "hope" together.	lle
Splice the 3th letter of "popular", the 2rd letter of "sugar", and the 2rd letter of "hook" together.	puo
Splice the 1st letter of "hear", the 9th letter of "statement", and the 5th letter of "write" together.	hte
Splice the 1st letter of "atomic", the 4th letter of "rival", and the 2rd letter of "joint" together.	aao
Splice the 7th letter of "confirm", the 7th letter of "popular", and the 5th letter of "shade" together.	mre
Splice the 4th letter of "phase", the 2rd letter of "soap", and the 4th letter of "atomic" together.	som
Splice the 6th letter of "lumber", the 6th letter of "elevator", and the 2rd letter of "story" together.	rtt
Splice the 8th letter of "neighbour", the 1st letter of "accident", and the 4th letter of "each" together.	uah
Splice the 8th letter of "official", the 7th letter of "district", and the 3th letter of "outlet" together.	lct
Splice the 5th letter of "explosion", the 3th letter of "butcher", and the 8th letter of "elevator" together.	otr
Splice the 7th letter of "sometime", the 2rd letter of "mate", and the 3th letter of "broken" together.	mao
Splice the 1st letter of "career", the 6th letter of "gymnasium", and the 5th letter of "accident" together.	csd
Splice the 2rd letter of "dispose", the 1st letter of "coin", and the 1st letter of "shady" together.	ics
Splice the 1st letter of "visible", the 1st letter of "Communism", and the 6th letter of "dispose" together.	vCs
Splice the 1st letter of "gown", the 1st letter of "grave", and the 3th letter of "involve" together.	ggv
Splice the 7th letter of "elevator", the 8th letter of "entrance", and the 2rd letter of "sometime" together.	oeo
Splice the 7th letter of "familiar", the 6th letter of "statement", and the 2rd letter of "greeting" together.	amr
Splice the 1st letter of "retain", the 6th letter of "retain", and the 2rd letter of "whoever" together.	rnh
Splice the 7th letter of "gymnasium", the 4th letter of "class", and the 1st letter of "lean" together.	isl
Splice the 1st letter of "shade", the 5th letter of "rabbit", and the 3th letter of "ought" together.	sig
Splice the 4th letter of "gown", the 3th letter of "supper", and the 2rd letter of "class" together.	npl
Splice the 3th letter of "Asian", the 3th letter of "anger", and the 1st letter of "write" together.	igw
Splice the 5th letter of "president", the 7th letter of "confirm", and the 5th letter of "rabbit" together.	imi
Splice the 5th letter of "dispose", the 4th letter of "soap", and the 1st letter of "soap" together.	ops
Splice the 5th letter of "grave", the 4th letter of "rival", and the 2rd letter of "official" together.	eaf
Splice the 1st letter of "qualify", the 5th letter of "write", and the 1st letter of "anger" together.	qea
Splice the 1st letter of "tablet", the 2rd letter of "evil", and the 7th letter of "dispose" together.	tve
Splice the 6th letter of "violet", the 5th letter of "follow", and the 2rd letter of "grave" together.	tor
Splice the 2rd letter of "matter", the 2rd letter of "about", and the 4th letter of "around" together.	abu
Splice the 3th letter of "recover", the 6th letter of "dispose", and the 6th letter of "recover" together.	cse
Splice the 5th letter of "insect", the 5th letter of "write", and the 1st letter of "spur" together.	ces
Splice the 3th letter of "president", the 1st letter of "anger", and the 4th letter of "explosion" together.	eal
Splice the 6th letter of "turnip", the 4th letter of "Asian", and the 6th letter of "violet" together.	pat
Splice the 2rd letter of "Asian", the 2rd letter of "mosquito", and the 7th letter of "college" together.	soe
Splice the 3th letter of "rabbit", the 2rd letter of "ladder", and the 4th letter of "violet" together.	bal
Splice the 6th letter of "Canada", the 2rd letter of "story", and the 4th letter of "career" together.	ate
Splice the 6th letter of "district", the 1st letter of "statement", and the 5th letter of "college" together.	ise
Splice the 4th letter of "lean", the 3th letter of "sometime", and the 5th letter of "attitude" together.	nmt
Splice the 4th letter of "class", the 2rd letter of "sleep", and the 4th letter of "gown" together.	sln
Splice the 5th letter of "contrast", the 6th letter of "Canada", and the 3th letter of "lean" together.	raa
Splice the 1st letter of "confirm", the 2rd letter of "follow", and the 4th letter of "float" together.	coa
Splice the 3th letter of "matter", the 1st letter of "phase", and the 2rd letter of "around" together.	tpr
Splice the 1st letter of "shady", the 2rd letter of "possess", and the 6th letter of "neighbour" together.	sob
Splice the 5th letter of "violet", the 5th letter of "sugar", and the 2rd letter of "sleep" together.	erl
Splice the 4th letter of "dispose", the 1st letter of "insect", and the 3th letter of "Canada" together.	pin
Splice the 6th letter of "explore", the 1st letter of "accident", and the 2rd letter of "sometime" together.	rao
Splice the 2rd letter of "recover", the 6th letter of "greeting", and the 5th letter of "outlet" together.	eie
Splice the 2rd letter of "write", the 1st letter of "write", and the 2rd letter of "phase" together.	rwh
Splice the 1st letter of "dispose", the 2rd letter of "neglect", and the 4th letter of "ought" together.	deh
Splice the 6th letter of "turnip", the 2rd letter of "gown", and the 5th letter of "write" together.	poe
Splice the 3th letter of "born", the 3th letter of "sleep", and the 2rd letter of "greeting" together.	rer
Splice the 6th letter of "rabbit", the 4th letter of "dispose", and the 2rd letter of "Canada" together.	tpa
Splice the 1st letter of "each", the 4th letter of "shady", and the 2rd letter of "official" together.	edf
Splice the 4th letter of "grave", the 2rd letter of "district", and the 1st letter of "class" together.	vic
Splice the 3th letter of "coin", the 2rd letter of "ever", and the 1st letter of "career" together.	ivc
Splice the 1st letter of "accident", the 4th letter of "around", and the 4th letter of "spur" together.	aur
Splice the 5th letter of "lumber", the 8th letter of "neighbour", and the 5th letter of "prior" together.	eur
Splice the 2rd letter of "gown", the 4th letter of "accident", and the 5th letter of "college" together.	oie
Splice the 2rd letter of "ladder", the 2rd letter of "mouse", and the 1st letter of "explore" together.	aoe
Splice the 2rd letter of "mouse", the 4th letter of "Canada", and the 4th letter of "popular" together.	oau
Splice the 5th letter of "neighbour", the 7th letter of "attitude", and the 5th letter of "outlet" together.	hde
Splice the 3th letter of "gown", the 2rd letter of "coin", and the 4th letter of "sugar" together.	woa
Splice the 6th letter of "represent", the 5th letter of "whoever", and the 7th letter of "laundry" together.	svy
Splice the 1st letter of "matter", the 7th letter of "familiar", and the 3th letter of "navy" together.	mav
Splice the 6th letter of "president", the 3th letter of "evil", and the 3th letter of "hook" together.	dio
Splice the 2rd letter of "career", the 7th letter of "mosquito", and the 2rd letter of "radiation" together.	ata
Splice the 4th letter of "spur", the 4th letter of "college", and the 2rd letter of "explore" together.	rlx
Splice the 3th letter of "shade", the 5th letter of "around", and the 6th letter of "tablet" together.	ant
Splice the 4th letter of "confirm", the 3th letter of "navy", and the 3th letter of "hook" together.	fvo
Splice the 6th letter of "rabbit", the 1st letter of "involve", and the 8th letter of "radiation" together.	tio
Splice the 4th letter of "shady", the 1st letter of "butcher", and the 1st letter of "lean" together.	dbl
Splice the 1st letter of "sugar", the 4th letter of "India", and the 8th letter of "greeting" together.	sig
Splice the 1st letter of "lean", the 2rd letter of "lean", and the 7th letter of "contrast" together.	les
Splice the 7th letter of "accident", the 3th letter of "mate", and the 1st letter of "follow" together.	ntf
Splice the 5th letter of "class", the 7th letter of "velocity", and the 1st letter of "card" together.	stc
Splice the 1st letter of "rabbit", the 4th letter of "atomic", and the 1st letter of "attitude" together.	rma
Splice the 1st letter of "lean", the 1st letter of "eighth", and the 1st letter of "familiar" together.	lef
Splice the 1st letter of "rival", the 2rd letter of "hope", and the 1st letter of "entrance" together.	roe
Splice the 3th letter of "rival", the 2rd letter of "ought", and the 5th letter of "qualify" together.	vui
Splice the 1st letter of "mosquito", the 1st letter of "illegal", and the 6th letter of "whoever" together.	mie
Splice the 2rd letter of "tomato", the 6th letter of "turbulent", and the 5th letter of "mouse" together.	ole
Splice the 1st letter of "anger", the 1st letter of "hardly", and the 1st letter of "story" together.	ahs
Splice the 1st letter of "retain", the 2rd letter of "official", and the 1st letter of "mate" together.	rfm
Splice the 1st letter of "rabbit", the 4th letter of "broken", and the 3th letter of "mosquito" together.	rks
Splice the 2rd letter of "career", the 6th letter of "rabbit", and the 6th letter of "statement" together.	atm
Splice the 3th letter of "acute", the 4th letter of "tomato", and the 2rd letter of "college" together.	uao
Splice the 8th letter of "district", the 4th letter of "acute", and the 3th letter of "contrast" together.	ttn
Splice the 2rd letter of "atomic", the 2rd letter of "college", and the 2rd letter of "qualify" together.	tou
Splice the 3th letter of "class", the 1st letter of "rabbit", and the 7th letter of "explosion" together.	ari
Splice the 1st letter of "coin", the 7th letter of "confirm", and the 2rd letter of "lean" together.	cme
Splice the 7th letter of "illegal", the 6th letter of "explosion", and the 3th letter of "greeting" together.	lse
Splice the 6th letter of "career", the 7th letter of "explosion", and the 1st letter of "possess" together.	rip
Splice the 1st letter of "write", the 1st letter of "tomato", and the 3th letter of "butcher" together.	wtt
Splice the 4th letter of "explore", the 2rd letter of "shady", and the 2rd letter of "lumber" together.	lhu
Splice the 7th letter of "accident", the 5th letter of "shady", and the 5th letter of "president" together.	nyi
Splice the 3th letter of "about", the 3th letter of "pull", and the 4th letter of "Communism" together.	olm
Splice the 5th letter of "qualify", the 2rd letter of "gown", and the 2rd letter of "whoever" together.	ioh
Splice the 3th letter of "spur", the 8th letter of "familiar", and the 4th letter of "Communism" together.	urm
Splice the 4th letter of "accident", the 4th letter of "lean", and the 3th letter of "hardly" together.	inr
Splice the 4th letter of "rival", the 4th letter of "joint", and the 1st letter of "tomato" together.	ant
Splice the 2rd letter of "file", the 2rd letter of "story", and the 5th letter of "rabbit" together.	iti
Splice the 4th letter of "joint", the 3th letter of "ever", and the 3th letter of "pull" together.	nel
Splice the 2rd letter of "story", the 1st letter of "prior", and the 6th letter of "greeting" together.	tpi
Splice the 2rd letter of "center", the 2rd letter of "supper", and the 2rd letter of "matter" together.	eua
Splice the 5th letter of "eighth", the 8th letter of "attitude", and the 3th letter of "Canada" together.	ten
Splice the 4th letter of "hear", the 3th letter of "turnip", and the 3th letter of "follow" together.	rrl
Splice the 3th letter of "reed", the 8th letter of "district", and the 3th letter of "shady" together.	eta
Splice the 1st letter of "shady", the 4th letter of "whoever", and the 2rd letter of "coin" together.	seo
Splice the 4th letter of "confirm", the 1st letter of "attitude", and the 2rd letter of "rabbit" together.	faa
Splice the 5th letter of "follow", the 2rd letter of "follow", and the 1st letter of "neighbour" together.	oon
Splice the 2rd letter of "gown", the 2rd letter of "contrast", and the 3th letter of "float" together.	ooo
Splice the 5th letter of "manual", the 5th letter of "president", and the 2rd letter of "anger" together.	ain
Splice the 2rd letter of "coin", the 2rd letter of "mouse", and the 2rd letter of "prior" together.	oor
Splice the 4th letter of "visible", the 2rd letter of "velocity", and the 5th letter of "hardware" together.	iew
Splice the 5th letter of "hardware", the 3th letter of "write", and the 1st letter of "hear" together.	wih
Splice the 2rd letter of "prior", the 3th letter of "outlet", and the 3th letter of "born" together.	rtr
Splice the 1st letter of "anger", the 2rd letter of "hear", and the 3th letter of "joint" together.	aei
Splice the 5th letter of "shade", the 4th letter of "write", and the 3th letter of "insect" together.	ets
Splice the 5th letter of "Canada", the 6th letter of "plough", and the 8th letter of "radiation" together.	dho
Splice the 3th letter of "eighth", the 6th letter of "eighth", and the 2rd letter of "Communism" together.	gho
Splice the 3th letter of "ought", the 1st letter of "evil", and the 2rd letter of "pull" together.	geu
Splice the 1st letter of "joint", the 2rd letter of "whoever", and the 8th letter of "gymnasium" together.	jhu
Splice the 7th letter of "attitude", the 5th letter of "shriek", and the 2rd letter of "explosion" together.	dex
Splice the 3th letter of "pull", the 6th letter of "statement", and the 5th letter of "ought" together.	lmt
Splice the 2rd letter of "spur", the 2rd letter of "file", and the 3th letter of "popular" together.	pip
Splice the 5th letter of "eighth", the 2rd letter of "district", and the 1st letter of "insect" together.	tii
Splice the 1st letter of "each", the 5th letter of "phase", and the 4th letter of "familiar" together.	eei
Splice the 2rd letter of "hope", the 1st letter of "joint", and the 3th letter of "float" together.	ojo
Splice the 5th letter of "Communism", the 1st letter of "acute", and the 6th letter of "butcher" together.	uae
Splice the 3th letter of "neglect", the 5th letter of "shade", and the 1st letter of "supper" together.	ges
Splice the 6th letter of "center", the 4th letter of "outlet", and the 6th letter of "mosquito" together.	rli
Splice the 6th letter of "plough", the 7th letter of "entrance", and the 4th letter of "matter" together.	hct
Splice the 7th letter of "gymnasium", the 5th letter of "matter", and the 3th letter of "gown" together.	iew
Splice the 3th letter of "class", the 2rd letter of "rival", and the 6th letter of "supper" together.	air
Splice the 3th letter of "mouse", the 4th letter of "born", and the 6th letter of "retain" together.	unn
Splice the 2rd letter of "rabbit", the 1st letter of "eighth", and the 2rd letter of "matter" together.	aea
Splice the 1st letter of "confirm", the 1st letter of "navy", and the 7th letter of "recover" together.	cnr
Splice the 6th letter of "contrast", the 2rd letter of "sometime", and the 1st letter of "rival" together.	aor
Splice the 3th letter of "whoever", the 1st letter of "recover", and the 2rd letter of "contrast" together.	oro
Splice the 5th letter of "tablet", the 6th letter of "involve", and the 1st letter of "joint" together.	evj
Splice the 3th letter of "visible", the 6th letter of "manual", and the 2rd letter of "gown" together.	slo
Splice the 8th letter of "elevator", the 3th letter of "tablet", and the 4th letter of "explosion" together.	rbl
Splice the 3th letter of "grave", the 2rd letter of "turbulent", and the 2rd letter of "sleep" together.	aul
Splice the 5th letter of "represent", the 2rd letter of "born", and the 1st letter of "matter" together.	eom
Splice the 5th letter of "India", the 1st letter of "joint", and the 6th letter of "lumber" together.	ajr
Splice the 4th letter of "laundry", the 1st letter of "lumber", and the 8th letter of "elevator" together.	nlr
Splice the 7th letter of "explosion", the 6th letter of "insect", and the 3th letter of "district" together.	its
Splice the 4th letter of "turnip", the 4th letter of "plough", and the 3th letter of "prior" together.	nui
Splice the 1st letter of "around", the 3th letter of "write", and the 7th letter of "laundry" together.	aiy
Splice the 1st letter of "India", the 1st letter of "anger", and the 1st letter of "class" together.	Iac
Splice the 4th letter of "phase", the 5th letter of "shade", and the 1st letter of "explore" together.	see
Splice the 3th letter of "tablet", the 4th letter of "rabbit", and the 7th letter of "popular" together.	bbr
Splice the 3th letter of "hear", the 2rd letter of "insect", and the 4th letter of "tablet" together.	anl
Splice the 9th letter of "neighbour", the 1st letter of "official", and the 2rd letter of "security" together.	roe
Splice the 3th letter of "shade", the 6th letter of "college", and the 4th letter of "navy" together.	agy
Splice the 5th letter of "float", the 6th letter of "familiar", and the 2rd letter of "plough" together.	til
Splice the 5th letter of "district", the 4th letter of "phase", and the 2rd letter of "recover" together.	rse
Splice the 4th letter of "prior", the 1st letter of "hardly", and the 7th letter of "college" together.	ohe
Splice the 1st letter of "reed", the 2rd letter of "manual", and the 4th letter of "confirm" together.	raf
Splice the 2rd letter of "atomic", the 3th letter of "pull", and the 3th letter of "explore" together.	tlp
Splice the 1st letter of "follow", the 6th letter of "represent", and the 4th letter of "prior" together.	fso
Splice the 1st letter of "college", the 4th letter of "spur", and the 2rd letter of "hook" together.	cro
Splice the 3th letter of "mosquito", the 1st letter of "attitude", and the 1st letter of "manual" together.	sam
Splice the 7th letter of "greeting", the 6th letter of "sometime", and the 3th letter of "elevator" together.	nie
Splice the 4th letter of "each", the 6th letter of "popular", and the 6th letter of "popular" together.	haa
Splice the 1st letter of "broken", the 4th letter of "mouse", and the 3th letter of "soap" together.	bsa
Splice the 5th letter of "dispose", the 5th letter of "ladder", and the 1st letter of "qualify" together.	oeq
Splice the 4th letter of "shriek", the 5th letter of "plough", and the 2rd letter of "follow" together.	igo
Splice the 3th letter of "coin", the 4th letter of "rival", and the 7th letter of "college" together.	iae
Splice the 2rd letter of "prior", the 6th letter of "violet", and the 1st letter of "grave" together.	rtg
Splice the 5th letter of "visible", the 6th letter of "Communism", and the 1st letter of "matter" together.	bnm
Splice the 1st letter of "each", the 6th letter of "greeting", and the 1st letter of "supper" together.	eis
Splice the 3th letter of "follow", the 5th letter of "official", and the 7th letter of "hardware" together.	lcr
Splice the 8th letter of "hardware", the 4th letter of "tablet", and the 2rd letter of "navy" together.	ela
Splice the 2rd letter of "neighbour", the 2rd letter of "evil", and the 5th letter of "rival" together.	evl
Splice the 4th letter of "sugar", the 4th letter of "Asian", and the 4th letter of "file" together.	aae
Splice the 1st letter of "manual", the 2rd letter of "hope", and the 3th letter of "violet" together.	moo
Splice the 4th letter of "explore", the 2rd letter of "ever", and the 4th letter of "hardware" together.	lvd
Splice the 2rd letter of "spur", the 1st letter of "shady", and the 1st letter of "card" together.	psc
